,FIPS,County_2012,Total Votes_2012,Democrat_2012,Republican_2012,Total Votes_2016,Democrat_2016,Republican_2016,2012,2016,Swap
0,8001,"Adams County, CO",161495,90843,66531,193677,96558,80082,24312,16476,0
1,8003,"Alamosa County, CO",6671,3782,2693,6939,3189,3046,1089,143,0
2,8005,"Arapahoe County, CO",254746,135433,114232,303048,159885,117053,21201,42832,0
3,8007,"Archuleta County, CO",6646,2637,3831,7339,2500,4264,-1194,-1764,0
4,8009,"Baca County, CO",2096,462,1554,2153,283,1753,-1092,-1470,0
5,8011,"Bent County, CO",1881,778,1053,1927,590,1188,-275,-598,0
6,8013,"Boulder County, CO",173207,120485,48526,188145,132334,41396,71959,90938,0
7,8014,"Broomfield County, CO",32191,16653,14765,37690,19731,14367,1888,5364,0
8,8015,"Chaffee County, CO",10217,4967,4949,11250,4888,5391,18,-503,1
9,8017,"Cheyenne County, CO",1045,162,858,1102,132,925,-696,-793,0
10,8019,"Clear Creek County, CO",5610,3041,2381,5866,2729,2575,660,154,0
11,8021,"Conejos County, CO",4027,2180,1794,4022,1771,1914,386,-143,1
12,8023,"Costilla County, CO",1804,1317,440,1848,1125,588,877,537,0
13,8025,"Crowley County, CO",1502,535,924,1527,339,1079,-389,-740,0
14,8027,"Custer County, CO",2697,862,1776,3066,797,2061,-914,-1264,0
15,8029,"Delta County, CO",15681,4542,10762,16790,4087,11655,-6220,-7568,0
16,8031,"Denver County, CO",285564,209759,69755,331852,244551,62690,140004,181861,0
17,8033,"Dolores County, CO",1218,329,838,1255,242,944,-509,-702,0
18,8035,"Douglas County, CO",150160,54093,93930,187500,68657,102573,-39837,-33916,0
19,8037,"Eagle County, CO",22374,12598,9317,25223,14099,8990,3281,5109,0
20,8041,"El Paso County, CO",275604,104989,163819,318968,108010,179228,-58830,-71218,0
21,8039,"Elbert County, CO",13993,3542,10148,15980,3134,11705,-6606,-8571,0
22,8043,"Fremont County, CO",20258,6644,13087,21973,5297,15122,-6443,-9825,0
23,8045,"Garfield County, CO",23695,10989,12159,26470,11271,13132,-1170,-1861,0
24,8047,"Gilpin County, CO",3271,1854,1320,3576,1634,1566,534,68,0
25,8049,"Grand County, CO",7961,3575,4149,8588,3358,4494,-574,-1136,0
26,8051,"Gunnison County, CO",7912,4563,3106,9412,5128,3289,1457,1839,0
27,8053,"Hinsdale County, CO",598,228,352,589,197,339,-124,-142,0
28,8055,"Huerfano County, CO",3623,1897,1615,3783,1633,1883,282,-250,1
29,8057,"Jackson County, CO",848,216,600,861,171,629,-384,-458,0
30,8059,"Jefferson County, CO",300151,153069,139960,328883,160776,138177,13109,22599,0
31,8061,"Kiowa County, CO",821,118,677,855,91,728,-559,-637,0
32,8063,"Kit Carson County, CO",3525,789,2664,3702,536,2967,-1875,-2431,0
33,8067,"La Plata County, CO",28475,15063,12554,31150,15525,12587,2509,2938,0
34,8065,"Lake County, CO",2993,1807,1087,3199,1616,1270,720,346,0
35,8069,"Larimer County, CO",161823,83103,74603,195981,93113,83430,8500,9683,0
36,8071,"Las Animas County, CO",6532,3282,3105,6793,2650,3710,177,-1060,1
37,8073,"Lincoln County, CO",2248,537,1663,2436,409,1892,-1126,-1483,0
38,8075,"Logan County, CO",9030,2675,6124,9722,1851,7282,-3449,-5431,0
39,8077,"Mesa County, CO",69033,22448,45087,77654,21729,49779,-22639,-28050,0
40,8079,"Mineral County, CO",650,291,344,652,237,344,-53,-107,0
41,8081,"Moffat County, CO",6042,1291,4616,6525,874,5305,-3325,-4431,0
42,8083,"Montezuma County, CO",12232,4486,7372,12858,3973,7853,-2886,-3880,0
43,8085,"Montrose County, CO",19054,5852,12789,21186,5466,14382,-6937,-8916,0
44,8087,"Morgan County, CO",10478,3761,6461,11960,3151,8145,-2700,-4994,0
45,8089,"Otero County, CO",8039,3566,4315,8452,2943,4928,-749,-1985,0
46,8091,"Ouray County, CO",3183,1640,1470,3310,1697,1351,170,346,0
47,8093,"Park County, CO",9054,3721,5085,10417,3421,6135,-1364,-2714,0
48,8095,"Phillips County, CO",2265,588,1637,2332,436,1791,-1049,-1355,0
49,8097,"Pitkin County, CO",9779,6648,2941,10523,7333,2550,3707,4783,0
50,8099,"Prowers County, CO",4809,1498,3200,5016,1186,3531,-1702,-2345,0
51,8101,"Pueblo County, CO",73306,40624,31023,78646,35875,36265,9601,-390,1
52,8103,"Rio Blanco County, CO",3311,561,2677,3450,436,2791,-2116,-2355,0
53,8105,"Rio Grande County, CO",5453,2428,2892,5534,2001,3085,-464,-1084,0
54,8107,"Routt County, CO",13038,7389,5361,13986,7600,5230,2028,2370,0
55,8109,"Saguache County, CO",2796,1762,937,2835,1417,1147,825,270,0
56,8111,"San Juan County, CO",506,266,212,506,265,215,54,50,0
57,8113,"San Miguel County, CO",4215,2961,1144,4329,2975,1033,1817,1942,0
58,8115,"Sedgwick County, CO",1337,419,881,1364,267,1015,-462,-748,0
59,8117,"Summit County, CO",15038,9169,5495,16174,9557,5100,3674,4457,0
60,8119,"Teller County, CO",12144,3894,7909,14444,3603,9745,-4015,-6142,0
61,8121,"Washington County, CO",2567,461,2059,2733,296,2299,-1598,-2003,0
62,8123,"Weld County, CO",112695,47418,62350,135430,46519,76651,-14932,-30132,0
63,8125,"Yuma County, CO",4481,950,3433,4791,726,3850,-2483,-3124,0
64,11001,"District of Columbia, DC",243348,222332,17337,311268,282830,12723,204995,270107,0
65,26001,"Alcona County, MI",6086,2462,3571,6198,1732,4201,-1109,-2469,0
66,26003,"Alger County, MI",4603,2212,2329,4518,1663,2585,-117,-922,0
67,26005,"Allegan County, MI",49199,19594,29023,56120,18050,34183,-9429,-16133,0
68,26007,"Alpena County, MI",14014,6549,7298,14768,4877,9090,-749,-4213,0
69,26009,"Antrim County, MI",13184,5107,7917,13667,4448,8469,-2810,-4021,0
70,26011,"Arenac County, MI",7826,3669,4054,7729,2384,4950,-385,-2566,0
71,26013,"Baraga County, MI",3490,1574,1866,3518,1156,2158,-292,-1002,0
72,26015,"Barry County, MI",28483,11496,16651,30517,9114,19202,-5155,-10088,0
73,26017,"Bay County, MI",51077,26797,23735,53274,21642,28328,3062,-6686,1
74,26019,"Benzie County, MI",9847,4683,5071,10228,4108,5539,-388,-1431,0
75,26021,"Berrien County, MI",72322,33465,38209,72031,29495,38647,-4744,-9152,0
76,26023,"Branch County, MI",16278,6526,9575,17663,5061,11786,-3049,-6725,0
77,26025,"Calhoun County, MI",58231,29270,28338,58902,24157,31494,932,-7337,1
78,26027,"Cass County, MI",22461,9587,12660,22595,7270,14243,-3073,-6973,0
79,26029,"Charlevoix County, MI",14064,5936,7997,14654,5137,8674,-2061,-3537,0
80,26031,"Cheboygan County, MI",13288,5829,7284,13672,4302,8683,-1455,-4381,0
81,26033,"Chippewa County, MI",15564,7100,8278,15552,5379,9122,-1178,-3743,0
82,26035,"Clare County, MI",13492,6337,6988,13449,4249,8505,-651,-4256,0
83,26037,"Clinton County, MI",39125,18187,20630,40655,16492,21636,-2443,-5144,0
84,26039,"Crawford County, MI",6814,2994,3744,6844,2110,4354,-750,-2244,0
85,26041,"Delta County, MI",18043,8330,9533,18594,6436,11121,-1203,-4685,0
86,26043,"Dickinson County, MI",12785,4952,7688,13232,3923,8580,-2736,-4657,0
87,26045,"Eaton County, MI",54707,27912,26193,56575,24938,27609,1719,-2671,1
88,26047,"Emmet County, MI",17672,7225,10253,18994,6972,10616,-3028,-3644,0
89,26049,"Genesee County, MI",202699,128972,71807,197641,102751,84175,57165,18576,0
90,26051,"Gladwin County, MI",12552,5760,6661,12542,3794,8124,-901,-4330,0
91,26053,"Gogebic County, MI",7576,4058,3444,7383,2925,4018,614,-1093,1
92,26055,"Grand Traverse County, MI",47901,20875,26532,51985,20965,27413,-5657,-6448,0
93,26057,"Gratiot County, MI",16011,7606,8236,16465,5666,9880,-630,-4214,0
94,26059,"Hillsdale County, MI",19081,7106,11727,19940,4799,14095,-4621,-9296,0
95,26061,"Houghton County, MI",14804,6530,8040,15761,6018,8475,-1510,-2457,0
96,26063,"Huron County, MI",15274,6432,8686,15944,4579,10692,-2254,-6113,0
97,26065,"Ingham County, MI",127579,80903,45365,132135,79110,43868,35538,35242,0
98,26067,"Ionia County, MI",25730,11016,14319,27039,8352,16635,-3303,-8283,0
99,26069,"Iosco County, MI",13330,6242,6906,13429,4345,8345,-664,-4000,0
100,26071,"Iron County, MI",5987,2687,3224,5960,2004,3675,-537,-1671,0
101,26073,"Isabella County, MI",24119,13038,10800,25540,11404,12338,2238,-934,1
102,26075,"Jackson County, MI",69323,32301,36298,70125,25795,39793,-3997,-13998,0
103,26077,"Kalamazoo County, MI",122880,69045,52660,126299,67148,51034,16385,16114,0
104,26079,"Kalkaska County, MI",8281,3268,4897,8833,2280,6116,-1629,-3836,0
105,26081,"Kent County, MI",295418,134560,157801,310894,138683,148180,-23241,-9497,0
106,26083,"Keweenaw County, MI",1388,582,774,1434,527,814,-192,-287,0
107,26085,"Lake County, MI",5287,2752,2487,5358,1939,3159,265,-1220,1
108,26087,"Lapeer County, MI",43025,18786,23725,45183,12734,30037,-4939,-17303,0
109,26089,"Leelanau County, MI",14164,6576,7483,14892,6774,7239,-907,-465,0
110,26091,"Lenawee County, MI",44619,21774,22351,46298,16750,26430,-577,-9680,0
111,26093,"Livingston County, MI",97959,37186,60000,106489,34384,65680,-22814,-31296,0
112,26095,"Luce County, MI",2477,951,1501,2591,681,1756,-550,-1075,0
113,26097,"Mackinac County, MI",6097,2652,3396,6144,2085,3744,-744,-1659,0
114,26099,"Macomb County, MI",403388,207992,191896,419312,176317,224665,16096,-48348,1
115,26101,"Manistee County, MI",12385,6467,5736,12660,4979,6915,731,-1936,1
116,26103,"Marquette County, MI",32144,18126,13609,33218,16042,14646,4517,1396,0
117,26105,"Mason County, MI",14588,6856,7580,14792,5281,8505,-724,-3224,0
118,26107,"Mecosta County, MI",16879,7515,9175,17259,5827,10305,-1660,-4478,0
119,26109,"Menominee County, MI",10922,5244,5565,10824,3539,6702,-321,-3163,0
120,26111,"Midland County, MI",41808,17480,23942,42776,15635,23846,-6462,-8211,0
121,26113,"Missaukee County, MI",7024,2274,4665,7317,1565,5386,-2391,-3821,0
122,26115,"Monroe County, MI",72682,36310,35593,74655,26863,43261,717,-16398,1
123,26117,"Montcalm County, MI",25383,11431,13624,26760,7874,16907,-2193,-9033,0
124,26119,"Montmorency County, MI",5051,2049,2928,5032,1287,3498,-879,-2211,0
125,26121,"Muskegon County, MI",76054,44436,30882,78723,37304,36127,13554,1177,0
126,26123,"Newaygo County, MI",21424,8723,12458,22782,6212,15173,-3735,-8961,0
127,26125,"Oakland County, MI",650306,349055,296531,668925,343070,289203,52524,53867,0
128,26127,"Oceana County, MI",11438,5063,6239,11930,3973,7228,-1176,-3255,0
129,26129,"Ogemaw County, MI",10361,4791,5437,10440,3030,6827,-646,-3797,0
130,26131,"Ontonagon County, MI",3535,1585,1906,3433,1176,2066,-321,-890,0
131,26133,"Osceola County, MI",10265,3981,6140,10609,2705,7336,-2159,-4631,0
132,26135,"Oscoda County, MI",4027,1654,2308,4092,1044,2843,-654,-1799,0
133,26137,"Otsego County, MI",11829,4681,7008,12610,3556,8266,-2327,-4710,0
134,26139,"Ottawa County, MI",132695,43068,88503,143848,44973,88467,-45435,-43494,0
135,26141,"Presque Isle County, MI",7077,3192,3794,7257,2400,4488,-602,-2088,0
136,26143,"Roscommon County, MI",13032,6198,6701,13096,4287,8141,-503,-3854,0
137,26145,"Saginaw County, MI",97903,54372,42716,94780,44396,45469,11656,-1073,1
138,26151,"Sanilac County, MI",18359,7212,10961,19249,4873,13446,-3749,-8573,0
139,26153,"Schoolcraft County, MI",4046,1865,2142,4177,1369,2556,-277,-1187,0
140,26155,"Shiawassee County, MI",33590,17197,15962,34111,12546,19230,1235,-6684,1
141,26147,"St. Clair County, MI",73740,33845,39076,78003,24553,49051,-5231,-24498,0
142,26149,"St. Joseph County, MI",23314,10106,12975,23967,7526,14884,-2869,-7358,0
143,26157,"Tuscola County, MI",26482,11643,14517,25928,7429,17102,-2874,-9673,0
144,26159,"Van Buren County, MI",32798,16288,16140,33274,13258,17890,148,-4632,1
145,26161,"Washtenaw County, MI",179016,120791,56401,190079,128483,50631,64390,77852,0
146,26163,"Wayne County, MI",814108,595253,213586,782719,519444,228993,381667,290451,0
147,26165,"Wexford County, MI",13859,5717,7972,15370,4436,10000,-2255,-5564,0
148,51001,"Accomack County, VA",16020,7653,8212,15818,6740,8583,-559,-1843,0
149,51003,"Albemarle County, VA",53732,29712,23263,56726,33345,19259,6449,14086,0
150,51510,"Alexandria city, VA",73470,52434,20205,75762,57242,13285,32229,43957,0
151,51005,"Alleghany County, VA",7162,3403,3595,7325,2166,4874,-192,-2708,0
152,51007,"Amelia County, VA",6885,2488,4324,7040,2128,4708,-1836,-2580,0
153,51009,"Amherst County, VA",14937,5898,8865,15396,5057,9719,-2967,-4662,0
154,51011,"Appomattox County, VA",7924,2453,5340,7997,2023,5715,-2887,-3692,0
155,51013,"Arlington County, VA",117279,81178,34433,121339,92016,20186,46745,71830,0
156,51015,"Augusta County, VA",33614,9448,23614,36343,8177,26163,-14166,-17986,0
157,51017,"Bath County, VA",2218,894,1274,2253,603,1548,-380,-945,0
158,51019,"Bedford County, VA",40750,10925,29281,42525,9768,30659,-18356,-20891,0
159,51021,"Bland County, VA",2937,735,2144,3139,453,2573,-1409,-2120,0
160,51023,"Botetourt County, VA",18208,5449,12471,18739,4494,13375,-7022,-8881,0
161,51520,"Bristol city, VA",7356,2487,4776,7027,1835,4892,-2289,-3057,0
162,51025,"Brunswick County, VA",8029,4993,2965,7669,4481,3046,2028,1435,0
163,51027,"Buchanan County, VA",9636,3094,6436,9247,1721,7296,-3342,-5575,0
164,51029,"Buckingham County, VA",7447,3747,3569,7289,3128,3950,178,-822,1
165,51530,"Buena Vista city, VA",2526,919,1564,2407,693,1430,-645,-737,0
166,51031,"Campbell County, VA",25632,7591,17687,27535,6664,19551,-10096,-12887,0
167,51033,"Caroline County, VA",13590,7258,6148,14248,6432,7147,1110,-715,1
168,51035,"Carroll County, VA",12315,3500,8351,13655,2559,10663,-4851,-8104,0
169,51036,"Charles City County, VA",4213,2772,1396,4107,2496,1476,1376,1020,0
170,51037,"Charlotte County, VA",5897,2502,3311,5807,2155,3479,-809,-1324,0
171,51540,"Charlottesville city, VA",21455,16267,4801,22467,17901,2960,11466,14941,0
172,51550,"Chesapeake city, VA",110105,54999,53845,112662,52627,54047,1154,-1420,1
173,51041,"Chesterfield County, VA",172223,78954,91174,176362,81074,85045,-12220,-3971,0
174,51043,"Clarke County, VA",7731,3237,4295,8213,3051,4661,-1058,-1610,0
175,51570,"Colonial Heights city, VA",8593,2541,5937,8457,2367,5681,-3396,-3314,0
176,51580,"Covington city, VA",2329,1319,975,2382,914,1349,344,-435,1
177,51045,"Craig County, VA",2664,830,1757,2791,541,2140,-927,-1599,0
178,51047,"Culpeper County, VA",20131,8263,11549,22218,7759,13349,-3286,-5590,0
179,51049,"Cumberland County, VA",5040,2422,2538,4906,2036,2697,-116,-661,0
180,51590,"Danville city, VA",20169,12215,7756,18940,11059,7303,4459,3756,0
181,51051,"Dickenson County, VA",6878,2472,4274,6440,1335,4932,-1802,-3597,0
182,51053,"Dinwiddie County, VA",13339,6425,6769,13575,5765,7447,-344,-1682,0
183,51595,"Emporia city, VA",2691,1793,886,2366,1530,789,907,741,0
184,51057,"Essex County, VA",5666,3009,2602,5372,2542,2657,407,-115,1
185,51059,"Fairfax County, VA",440174,260835,173786,551183,355133,157710,87049,197423,0
186,51600,"Fairfax city, VA",11577,6636,4762,12028,7367,3702,1874,3665,0
187,51610,"Falls Church city, VA",7244,5006,2141,7757,5819,1324,2865,4495,0
188,51061,"Fauquier County, VA",35339,13891,20955,37460,12971,22127,-7064,-9156,0
189,51063,"Floyd County, VA",7626,2732,4671,8050,2300,5293,-1939,-2993,0
190,51065,"Fluvanna County, VA",12724,5885,6678,13592,5760,7025,-793,-1265,0
191,51067,"Franklin County, VA",26633,9082,16685,26971,7257,18569,-7603,-11312,0
192,51620,"Franklin city, VA",4351,2830,1496,4061,2519,1421,1334,1098,0
193,51069,"Frederick County, VA",36272,12683,22851,40440,11932,26083,-10168,-14151,0
194,51630,"Fredericksburg city, VA",11396,7114,4054,11257,6707,3744,3060,2963,0
195,51640,"Galax city, VA",2273,900,1332,2376,681,1603,-432,-922,0
196,51071,"Giles County, VA",7544,2730,4660,8212,1950,5910,-1930,-3960,0
197,51073,"Gloucester County, VA",19246,6764,12137,19619,5404,13096,-5373,-7692,0
198,51075,"Goochland County, VA",13287,4676,8448,14037,4889,8384,-3772,-3495,0
199,51077,"Grayson County, VA",7146,2094,4801,7285,1407,5592,-2707,-4185,0
200,51079,"Greene County, VA",8993,3284,5558,9607,2924,5945,-2274,-3021,0
201,51081,"Greensville County, VA",4925,3135,1766,4363,2558,1737,1369,821,0
202,51083,"Halifax County, VA",16663,7760,8699,16994,6897,9704,-939,-2807,0
203,51650,"Hampton city, VA",71713,51733,19193,62277,41312,17902,32540,23410,0
204,51085,"Hanover County, VA",58936,18283,39920,62723,19382,39630,-21637,-20248,0
205,51660,"Harrisonburg city, VA",15541,8650,6564,17987,10212,6262,2086,3950,0
206,51087,"Henrico County, VA",161195,89116,70235,163536,93935,59857,18881,34078,0
207,51089,"Henry County, VA",24927,10312,13980,24091,8198,15208,-3668,-7010,0
208,51091,"Highland County, VA",1411,459,924,1391,371,958,-465,-587,0
209,51670,"Hopewell city, VA",9011,5178,3737,9008,4724,3885,1441,839,0
210,51093,"Isle of Wight County, VA",20772,8754,11797,21075,7881,12204,-3043,-4323,0
211,51095,"James City County, VA",41134,17854,22830,43169,19105,21306,-4976,-2201,0
212,51097,"King and Queen County, VA",3645,1743,1863,3690,1468,2099,-120,-631,0
213,51099,"King George County, VA",11287,4476,6603,12050,4007,7341,-2127,-3334,0
214,51101,"King William County, VA",8865,3326,5445,9146,2760,5975,-2119,-3215,0
215,51103,"Lancaster County, VA",7052,3144,3749,6645,2869,3523,-605,-654,0
216,51105,"Lee County, VA",9588,2593,6845,9399,1627,7543,-4252,-5916,0
217,51678,"Lexington city, VA",2677,1484,1146,2465,1514,766,338,748,0
218,51107,"Loudoun County, VA",158648,81900,74794,183050,100795,69949,7106,30846,0
219,51109,"Louisa County, VA",16404,6949,9207,17612,6212,10528,-2258,-4316,0
220,51111,"Lunenburg County, VA",5726,2684,2969,5586,2227,3204,-285,-977,0
221,51680,"Lynchburg city, VA",36242,15905,19752,35657,14792,17982,-3847,-3190,0
222,51113,"Madison County, VA",6597,2637,3864,6979,2203,4419,-1227,-2216,0
223,51683,"Manassas city, VA",15154,8478,6463,15411,8423,5953,2015,2470,0
224,51685,"Manassas Park city, VA",4627,2873,1696,5232,3204,1733,1177,1471,0
225,51690,"Martinsville city, VA",6277,3855,2312,5907,3533,2149,1543,1384,0
226,51115,"Mathews County, VA",5364,1807,3488,5311,1563,3517,-1681,-1954,0
227,51117,"Mecklenburg County, VA",14813,6786,7855,14945,6285,8288,-1069,-2003,0
228,51119,"Middlesex County, VA",6067,2370,3619,6017,2108,3670,-1249,-1562,0
229,51121,"Montgomery County, VA",40938,19903,20006,43031,20021,19459,-103,562,0
230,51125,"Nelson County, VA",8225,4171,3944,8311,3689,4154,227,-465,1
231,51127,"New Kent County, VA",10941,3555,7246,12233,3546,8118,-3691,-4572,0
232,51700,"Newport News city, VA",79169,50990,27224,75637,45618,25468,23766,20150,0
233,51710,"Norfolk city, VA",77925,55654,21366,83385,57023,21552,34288,35471,0
234,51131,"Northampton County, VA",6481,3737,2676,6168,3255,2686,1061,569,0
235,51133,"Northumberland County, VA",7542,3186,4308,7397,2852,4302,-1122,-1450,0
236,51720,"Norton city, VA",1486,566,895,1460,383,1021,-329,-638,0
237,51135,"Nottoway County, VA",6844,3344,3409,6744,2829,3712,-65,-883,0
238,51137,"Orange County, VA",16330,6870,9244,17267,5957,10521,-2374,-4564,0
239,51139,"Page County, VA",10205,3724,6344,10740,2514,7831,-2620,-5317,0
240,51141,"Patrick County, VA",8241,2417,5622,8525,1768,6454,-3205,-4686,0
241,51730,"Petersburg city, VA",15977,14377,1526,13786,12021,1451,12851,10570,0
242,51143,"Pittsylvania County, VA",30578,10855,19275,31598,9199,21554,-8420,-12355,0
243,51735,"Poquoson city, VA",7098,1679,5312,7177,1601,5092,-3633,-3491,0
244,51740,"Portsmouth city, VA",41860,28994,12407,43261,28497,12795,16587,15702,0
245,51145,"Powhatan County, VA",15466,4066,11192,16888,4060,11885,-7126,-7825,0
246,51147,"Prince Edward County, VA",9224,5132,3952,9143,4591,4101,1180,490,0
247,51149,"Prince George County, VA",17180,7671,9350,16184,6419,9157,-1679,-2738,0
248,51153,"Prince William County, VA",179648,103161,74371,196442,113144,71721,28790,41423,0
249,51155,"Pulaski County, VA",14657,5287,8917,15165,4172,10322,-3630,-6150,0
250,51750,"Radford city, VA",5382,2732,2520,6082,2925,2638,212,287,0
251,51157,"Rappahannock County, VA",4331,1971,2307,4483,1747,2539,-336,-792,0
252,51159,"Richmond County, VA",3768,1574,2160,3661,1347,2213,-586,-866,0
253,51760,"Richmond city, VA",92175,71037,19732,103406,81259,15581,51305,65678,0
254,51161,"Roanoke County, VA",53793,19589,33344,51489,17200,31408,-13755,-14208,0
255,51770,"Roanoke city, VA",37479,22179,14116,39466,22286,14789,8063,7497,0
256,51163,"Rockbridge County, VA",10155,4087,5898,10795,3508,6680,-1811,-3172,0
257,51165,"Rockingham County, VA",34783,10059,24173,37487,9366,25990,-14114,-16624,0
258,51167,"Russell County, VA",12063,3716,8177,12246,2330,9521,-4461,-7191,0
259,51775,"Salem city, VA",12270,4756,7289,12225,4202,7226,-2533,-3024,0
260,51169,"Scott County, VA",9964,2395,7439,10100,1581,8247,-5044,-6666,0
261,51171,"Shenandoah County, VA",19289,6462,12526,20508,5273,14094,-6064,-8821,0
262,51173,"Smyth County, VA",12751,4169,8376,12890,2665,9750,-4207,-7085,0
263,51175,"Southampton County, VA",9261,4437,4733,8872,3595,5035,-296,-1440,0
264,51177,"Spotsylvania County, VA",57797,25150,31818,62549,24207,34623,-6668,-10416,0
265,51179,"Stafford County, VA",60338,27130,32429,65934,27908,33868,-5299,-5960,0
266,51790,"Staunton city, VA",11154,5710,5257,11255,5333,5133,453,200,0
267,51800,"Suffolk city, VA",42381,24194,17778,43240,23280,18006,6416,5274,0
268,51181,"Surry County, VA",4302,2574,1671,4228,2272,1819,903,453,0
269,51183,"Sussex County, VA",5421,3350,2021,5044,2879,2055,1329,824,0
270,51185,"Tazewell County, VA",17712,3661,13843,18566,2895,15168,-10182,-12273,0
271,51810,"Virginia Beach city, VA",195823,94163,99107,203019,91032,98224,-4944,-7192,0
272,51187,"Warren County, VA",16636,6449,9865,17951,5169,11773,-3416,-6604,0
273,51191,"Washington County, VA",25582,7076,18141,25846,5553,19320,-11065,-13767,0
274,51820,"Waynesboro city, VA",8772,3836,4789,9204,3764,4801,-953,-1037,0
275,51193,"Westmoreland County, VA",8689,4155,4116,8574,3836,4448,39,-612,1
276,51830,"Williamsburg city, VA",7722,4901,2678,7626,5206,1925,2223,3281,0
277,51840,"Winchester city, VA",10254,5089,4943,10665,5164,4790,146,374,0
278,51195,"Wise County, VA",14937,3751,11041,15163,2701,12086,-7290,-9385,0
279,51197,"Wythe County, VA",12336,3782,8324,13328,2770,10046,-4542,-7276,0
280,51199,"York County, VA",33848,13165,20182,34113,12999,18837,-7017,-5838,0
281,4001,"Apache County, AZ",25839,17147,8250,27661,17083,8240,8897,8843,0
282,4003,"Cochise County, AZ",46447,17377,28197,50015,17450,28092,-10820,-10642,0
283,4005,"Coconino County, AZ",47581,26772,19720,59784,32404,21108,7052,11296,0
284,4007,"Gila County, AZ",20487,7293,12846,22515,7003,14182,-5553,-7179,0
285,4009,"Graham County, AZ",11855,3609,8076,12281,3301,8025,-4467,-4724,0
286,4011,"Greenlee County, AZ",2972,1310,1590,3300,1092,1892,-280,-800,0
287,4012,"La Paz County, AZ",4922,1619,3205,5951,1575,4003,-1586,-2428,0
288,4013,"Maricopa County, AZ",1233471,532284,680089,1567834,702907,747361,-147805,-44454,0
289,4015,"Mohave County, AZ",68125,18991,47901,79943,17455,58282,-28910,-40827,0
290,4017,"Navajo County, AZ",37323,16945,19880,40294,16459,20577,-2935,-4118,0
291,4019,"Pima County, AZ",357223,186456,165237,421640,224661,167428,21219,57233,0
292,4021,"Pinal County, AZ",102139,41428,58947,129546,47892,72819,-17519,-24927,0
293,4023,"Santa Cruz County, AZ",13894,9486,4235,16433,11690,3897,5251,7793,0
294,4025,"Yavapai County, AZ",96790,32624,62385,114450,35590,71330,-29761,-35740,0
295,4027,"Yuma County, AZ",40318,17328,22493,53010,24605,25165,-5165,-560,0
296,5001,"Arkansas County, AR",6488,2454,3892,6212,1939,3826,-1438,-1887,0
297,5003,"Ashley County, AR",7915,2855,4866,8083,2408,5338,-2011,-2930,0
298,5005,"Baxter County, AR",19339,5172,13688,19766,4169,14682,-8516,-10513,0
299,5007,"Benton County, AR",70628,20267,48649,96824,28005,60871,-28382,-32866,0
300,5009,"Boone County, AR",15363,3762,11143,16111,2926,12235,-7381,-9309,0
301,5011,"Bradley County, AR",3634,1447,2118,3653,1317,2164,-671,-847,0
302,5013,"Calhoun County, AR",2174,660,1458,2269,639,1556,-798,-917,0
303,5015,"Carroll County, AR",10172,3691,6121,10758,3342,6786,-2430,-3444,0
304,5017,"Chicot County, AR",4361,2649,1670,4176,2350,1716,979,634,0
305,5019,"Clark County, AR",8406,3808,4343,8526,3620,4404,-535,-784,0
306,5021,"Clay County, AR",5110,1738,3225,5200,1199,3781,-1487,-2582,0
307,5023,"Cleburne County, AR",11643,2618,8691,12085,2101,9458,-6073,-7357,0
308,5025,"Cleveland County, AR",3259,844,2307,3354,723,2462,-1463,-1739,0
309,5027,"Columbia County, AR",9455,3557,5790,8887,3140,5456,-2233,-2316,0
310,5029,"Conway County, AR",7724,3003,4511,7927,2656,4849,-1508,-2193,0
311,5031,"Craighead County, AR",31207,10351,20044,35573,10538,22892,-9693,-12354,0
312,5033,"Crawford County, AR",20562,4872,15125,22450,4488,16686,-10253,-12198,0
313,5035,"Crittenden County, AR",15513,9092,6192,15952,8410,6964,2900,1446,0
314,5037,"Cross County, AR",6680,2279,4268,6874,1999,4584,-1989,-2585,0
315,5039,"Dallas County, AR",3083,1337,1664,2771,1165,1509,-327,-344,0
316,5041,"Desha County, AR",4240,2353,1807,4257,2228,1919,546,309,0
317,5043,"Drew County, AR",6626,2627,3883,6595,2365,3968,-1256,-1603,0
318,5045,"Faulkner County, AR",41322,13559,26653,47527,14629,29346,-13094,-14717,0
319,5047,"Franklin County, AR",6539,1725,4631,6770,1376,5039,-2906,-3663,0
320,5049,"Fulton County, AR",4522,1452,2949,4772,1067,3471,-1497,-2404,0
321,5051,"Garland County, AR",39241,13317,25031,40805,12311,26087,-11714,-13776,0
322,5053,"Grant County, AR",6478,1467,4829,7445,1373,5725,-3362,-4352,0
323,5055,"Greene County, AR",13754,3998,9066,14600,3071,10720,-5068,-7649,0
324,5057,"Hempstead County, AR",6919,2466,4284,7049,2377,4401,-1818,-2024,0
325,5059,"Hot Spring County, AR",11239,3824,7087,11944,3149,8172,-3263,-5023,0
326,5061,"Howard County, AR",4419,1460,2862,4674,1351,3157,-1402,-1806,0
327,5063,"Independence County, AR",12390,3279,8724,13614,2881,9936,-5445,-7055,0
328,5065,"Izard County, AR",5313,1563,3571,5448,1113,4042,-2008,-2929,0
329,5067,"Jackson County, AR",5338,2093,3065,5156,1583,3267,-972,-1684,0
330,5069,"Jefferson County, AR",27364,17456,9515,25894,15772,9250,7941,6522,0
331,5071,"Johnson County, AR",8064,2785,5045,9112,2427,6091,-2260,-3664,0
332,5073,"Lafayette County, AR",2928,1173,1712,2860,1032,1758,-539,-726,0
333,5075,"Lawrence County, AR",5537,1786,3535,5685,1263,4064,-1749,-2801,0
334,5077,"Lee County, AR",3424,2107,1280,3026,1735,1229,827,506,0
335,5079,"Lincoln County, AR",3725,1424,2199,3826,1252,2455,-775,-1203,0
336,5081,"Little River County, AR",5051,1552,3385,5227,1397,3605,-1833,-2208,0
337,5083,"Logan County, AR",7330,2009,5078,7921,1715,5746,-3069,-4031,0
338,5085,"Lonoke County, AR",23272,5237,17450,27100,5664,19958,-12213,-14294,0
339,5087,"Madison County, AR",6567,2099,4262,6841,1588,4928,-2163,-3340,0
340,5089,"Marion County, AR",7029,2024,4771,7107,1434,5336,-2747,-3902,0
341,5091,"Miller County, AR",15325,4517,10619,16091,4273,11294,-6102,-7021,0
342,5093,"Mississippi County, AR",13349,6445,6599,13204,5670,7061,-154,-1391,0
343,5095,"Monroe County, AR",3230,1583,1585,2884,1312,1489,-2,-177,0
344,5097,"Montgomery County, AR",3403,920,2368,3559,748,2643,-1448,-1895,0
345,5099,"Nevada County, AR",3384,1314,1996,3246,1157,2000,-682,-843,0
346,5101,"Newton County, AR",3661,993,2508,3753,699,2875,-1515,-2176,0
347,5103,"Ouachita County, AR",10303,4626,5516,9935,4321,5351,-890,-1030,0
348,5105,"Perry County, AR",3937,1187,2580,4306,1049,3008,-1393,-1959,0
349,5107,"Phillips County, AR",7900,5179,2591,6953,4310,2446,2588,1864,0
350,5109,"Pike County, AR",3787,850,2847,3981,685,3150,-1997,-2465,0
351,5111,"Poinsett County, AR",7550,2387,4967,7722,1880,5502,-2580,-3622,0
352,5113,"Polk County, AR",7721,1556,5950,8231,1212,6618,-4394,-5406,0
353,5115,"Pope County, AR",20390,5108,14733,22569,5000,16256,-9625,-11256,0
354,5117,"Prairie County, AR",3134,877,2149,3444,814,2505,-1272,-1691,0
355,5119,"Pulaski County, AR",159055,87055,68856,159776,89574,61257,18199,28317,0
356,5121,"Randolph County, AR",5948,2040,3699,6379,1425,4509,-1659,-3084,0
357,5123,"St. Francis County, AR",8021,4652,3287,7430,4031,3195,1365,836,0
358,5125,"Saline County, AR",47059,12868,32962,52100,13256,35863,-20094,-22607,0
359,5127,"Scott County, AR",3637,895,2630,3510,602,2731,-1735,-2129,0
360,5129,"Searcy County, AR",3694,814,2699,3728,601,2955,-1885,-2354,0
361,5131,"Sebastian County, AR",43340,13083,29158,44637,12300,29127,-16075,-16827,0
362,5133,"Sevier County, AR",4328,1042,3135,4562,1075,3282,-2093,-2207,0
363,5135,"Sharp County, AR",7282,2092,4920,7249,1472,5407,-2828,-3935,0
364,5137,"Stone County, AR",5351,1356,3773,5577,1203,4113,-2417,-2910,0
365,5139,"Union County, AR",17160,6182,10696,16894,5855,10456,-4514,-4601,0
366,5141,"Van Buren County, AR",6421,1826,4362,7339,1549,5382,-2536,-3833,0
367,5143,"Washington County, AR",70231,28136,39570,81861,33366,41476,-11434,-8110,0
368,5145,"White County, AR",26508,5765,20005,27999,5170,21077,-14240,-15907,0
369,5147,"Woodruff County, AR",2685,1340,1227,2571,1118,1347,113,-229,1
370,5149,"Yell County, AR",5971,1720,4041,6439,1480,4608,-2321,-3128,0
371,49001,"Beaver County, UT",2534,341,2153,2505,264,1838,-1812,-1574,0
372,49003,"Box Elder County, UT",18092,1830,15969,19878,2282,12230,-14139,-9948,0
373,49005,"Cache County, UT",37099,5434,30818,46718,8563,21139,-25384,-12576,0
374,49007,"Carbon County, UT",7231,2204,4834,7999,1717,5275,-2630,-3558,0
375,49009,"Daggett County, UT",509,91,399,477,77,331,-308,-254,0
376,49011,"Davis County, UT",112568,20417,90030,140288,28776,62219,-69613,-33443,0
377,49013,"Duchesne County, UT",6273,570,5608,6988,500,5508,-5038,-5008,0
378,49015,"Emery County, UT",4414,569,3743,4315,380,3425,-3174,-3045,0
379,49017,"Garfield County, UT",2157,306,1811,2344,358,1606,-1505,-1248,0
380,49019,"Grand County, UT",3812,1678,1917,4601,1960,1975,-239,-15,0
381,49021,"Iron County, UT",13168,1720,11172,17831,2450,11561,-9452,-9111,0
382,49023,"Juab County, UT",3907,436,3400,4221,442,2827,-2964,-2385,0
383,49025,"Kane County, UT",3281,718,2463,3537,741,2265,-1745,-1524,0
384,49027,"Millard County, UT",4958,424,4421,5269,431,3860,-3997,-3429,0
385,49029,"Morgan County, UT",4370,386,3910,5192,577,3188,-3524,-2611,0
386,49031,"Piute County, UT",781,74,696,729,47,626,-622,-579,0
387,49033,"Rich County, UT",999,83,907,1109,104,797,-824,-693,0
388,49035,"Salt Lake County, UT",341664,132686,198739,423743,175863,138043,-66053,37820,0
389,49037,"San Juan County, UT",5159,2062,3006,5534,2042,2645,-944,-603,0
390,49039,"Sanpete County, UT",8804,889,7767,10247,1061,6673,-6878,-5612,0
391,49041,"Sevier County, UT",7781,701,6961,8654,695,6740,-6260,-6045,0
392,49043,"Summit County, UT",16616,7656,8464,20885,10503,7333,-808,3170,0
393,49045,"Tooele County, UT",16422,3794,12240,21962,4573,11169,-8446,-6596,0
394,49047,"Uintah County, UT",11116,962,10001,12864,995,9810,-9039,-8815,0
395,49049,"Utah County, UT",161278,15791,142337,203642,28522,102182,-126546,-73660,0
396,49051,"Wasatch County, UT",9109,2097,6852,12266,3063,6115,-4755,-3052,0
397,49053,"Washington County, UT",49733,7762,41104,62371,10288,42650,-33342,-32362,0
398,49055,"Wayne County, UT",1323,213,1087,1426,271,966,-874,-695,0
399,49057,"Weber County, UT",68143,17569,48938,86006,23131,40235,-31369,-17104,0
400,24001,"Allegany County, MD",27817,9001,18158,30654,7875,21270,-9157,-13395,0
401,24003,"Anne Arundel County, MD",239189,115960,118165,270081,128419,122403,-2205,6016,0
402,24005,"Baltimore County, MD",354655,202733,144686,390682,218412,149477,58047,68935,0
403,24510,"Baltimore city, MD",229897,201042,25501,239402,202673,25205,175541,177468,0
404,24009,"Calvert County, MD",42168,18963,22413,47408,18225,26176,-3450,-7951,0
405,24011,"Caroline County, MD",12526,4621,7674,14113,4009,9368,-3053,-5359,0
406,24013,"Carroll County, MD",82171,26067,53960,91848,26567,58215,-27893,-31648,0
407,24015,"Cecil County, MD",40037,15489,23660,45269,13650,28868,-8171,-15218,0
408,24017,"Charles County, MD",70167,45621,23637,78303,49341,25614,21984,23727,0
409,24019,"Dorchester County, MD",14249,6570,7514,15225,6245,8413,-944,-2168,0
410,24021,"Frederick County, MD",109127,51187,55495,125677,56522,59522,-4308,-3000,0
411,24023,"Garrett County, MD",12113,2792,9102,14011,2567,10776,-6310,-8209,0
412,24025,"Harford County, MD",118417,46390,69496,133672,47077,77860,-23106,-30783,0
413,24027,"Howard County, MD",141167,84017,54094,162193,102597,47484,29923,55113,0
414,24029,"Kent County, MD",9143,4453,4533,10021,4575,4876,-80,-301,0
415,24031,"Montgomery County, MD",404214,286493,110940,478873,357837,92704,175553,265133,0
416,24033,"Prince George's County, MD",352292,317342,32236,390385,344049,32811,285106,311238,0
417,24035,"Queen Anne's County, MD",23153,7898,14879,26523,7973,16993,-6981,-9020,0
418,24039,"Somerset County, MD",9272,4478,4706,9900,4196,5341,-228,-1145,0
419,24037,"St. Mary's County, MD",44076,17982,25096,49842,17534,28663,-7114,-11129,0
420,24041,"Talbot County, MD",18671,7983,10442,20553,8653,10724,-2459,-2071,0
421,24043,"Washington County, MD",58653,23282,34113,65991,21129,40998,-10831,-19869,0
422,24045,"Wicomico County, MD",38256,17481,20136,42547,18050,22198,-2655,-4148,0
423,24047,"Worcester County, MD",24526,9841,14334,28273,9753,17210,-4493,-7457,0
424,46003,"Aurora County, SD",1400,556,804,1407,340,974,-248,-634,0
425,46005,"Beadle County, SD",7263,2881,4230,6772,1912,4455,-1349,-2543,0
426,46007,"Bennett County, SD",1203,548,626,1149,412,666,-78,-254,0
427,46009,"Bon Homme County, SD",3074,1167,1830,2974,704,2105,-663,-1401,0
428,46011,"Brookings County, SD",12398,5826,6219,12680,4879,6748,-393,-1869,0
429,46013,"Brown County, SD",16066,7249,8320,16114,5452,9613,-1071,-4161,0
430,46015,"Brule County, SD",2379,824,1499,2288,571,1565,-675,-994,0
431,46017,"Buffalo County, SD",641,472,166,490,296,171,306,125,0
432,46019,"Butte County, SD",4201,1000,3068,4351,696,3357,-2068,-2661,0
433,46021,"Campbell County, SD",787,153,616,831,105,704,-463,-599,0
434,46023,"Charles Mix County, SD",3762,1482,2229,3433,935,2382,-747,-1447,0
435,46025,"Clark County, SD",1821,713,1067,1657,398,1139,-354,-741,0
436,46027,"Clay County, SD",5233,2955,2146,5069,2608,2109,809,499,0
437,46029,"Codington County, SD",11524,4588,6696,11669,3174,7764,-2108,-4590,0
438,46031,"Corson County, SD",1199,647,515,1175,535,588,132,-53,1
439,46033,"Custer County, SD",4520,1335,3062,4721,1121,3293,-1727,-2172,0
440,46035,"Davison County, SD",7968,3042,4754,7952,2355,5157,-1712,-2802,0
441,46037,"Day County, SD",2873,1497,1320,2747,974,1627,177,-653,1
442,46039,"Deuel County, SD",2171,941,1175,2080,570,1366,-234,-796,0
443,46041,"Dewey County, SD",1895,1207,663,1708,888,723,544,165,0
444,46043,"Douglas County, SD",1690,332,1334,1605,214,1338,-1002,-1124,0
445,46045,"Edmunds County, SD",1936,622,1264,1918,380,1433,-642,-1053,0
446,46047,"Fall River County, SD",3511,1137,2256,3563,821,2511,-1119,-1690,0
447,46049,"Faulk County, SD",1127,331,765,1118,204,858,-434,-654,0
448,46051,"Grant County, SD",3606,1493,2034,3564,971,2382,-541,-1411,0
449,46053,"Gregory County, SD",2151,599,1507,2091,391,1600,-908,-1209,0
450,46055,"Haakon County, SD",1092,138,940,1044,77,936,-802,-859,0
451,46057,"Hamlin County, SD",2793,921,1803,2762,555,2051,-882,-1496,0
452,46059,"Hand County, SD",1848,575,1242,1818,334,1391,-667,-1057,0
453,46061,"Hanson County, SD",2416,760,1627,2006,424,1497,-867,-1073,0
454,46063,"Harding County, SD",739,82,638,770,38,695,-556,-657,0
455,46065,"Hughes County, SD",8155,2786,5219,8175,2450,5174,-2433,-2724,0
456,46067,"Hutchinson County, SD",3425,923,2451,3365,692,2517,-1528,-1825,0
457,46069,"Hyde County, SD",733,189,531,690,125,543,-342,-418,0
458,46071,"Jackson County, SD",1106,426,661,1095,323,722,-235,-399,0
459,46073,"Jerauld County, SD",1006,452,538,967,264,648,-86,-384,0
460,46075,"Jones County, SD",609,108,490,558,69,450,-382,-381,0
461,46077,"Kingsbury County, SD",2608,1092,1451,2551,703,1680,-359,-977,0
462,46079,"Lake County, SD",6285,2724,3419,6786,2314,4038,-695,-1724,0
463,46081,"Lawrence County, SD",11359,3973,7025,11842,3356,7411,-3052,-4055,0
464,46083,"Lincoln County, SD",21952,7982,13611,25231,8076,15499,-5629,-7423,0
465,46085,"Lyman County, SD",1569,605,933,1421,369,977,-328,-608,0
466,46091,"Marshall County, SD",1987,1061,889,1947,754,1056,172,-302,1
467,46087,"McCook County, SD",2613,905,1655,2587,623,1794,-750,-1171,0
468,46089,"McPherson County, SD",1215,272,921,1137,192,892,-649,-700,0
469,46093,"Meade County, SD",10811,2928,7560,11621,2223,8441,-4632,-6218,0
470,46095,"Mellette County, SD",769,375,381,683,238,402,-6,-164,0
471,46097,"Miner County, SD",1140,479,636,1064,281,706,-157,-425,0
472,46099,"Minnehaha County, SD",76565,34668,40330,78263,30610,42043,-5662,-11433,0
473,46101,"Moody County, SD",3033,1429,1535,2933,1043,1731,-106,-688,0
474,46103,"Pennington County, SD",44458,15122,28229,47743,14074,29804,-13107,-15730,0
475,46105,"Perkins County, SD",1590,319,1205,1606,188,1333,-886,-1145,0
476,46107,"Potter County, SD",1381,339,1029,1337,215,1071,-690,-856,0
477,46109,"Roberts County, SD",4256,2302,1883,3889,1540,2144,419,-604,1
478,46111,"Sanborn County, SD",1115,389,688,1123,241,819,-299,-578,0
479,46115,"Spink County, SD",3041,1300,1670,2951,919,1854,-370,-935,0
480,46117,"Stanley County, SD",1540,435,1063,1567,329,1148,-628,-819,0
481,46119,"Sully County, SD",816,186,611,861,137,679,-425,-542,0
482,46121,"Todd County, SD",2497,1976,498,2125,1505,487,1478,1018,0
483,46123,"Tripp County, SD",2691,737,1905,2630,462,2069,-1168,-1607,0
484,46125,"Turner County, SD",4210,1411,2715,4150,961,2937,-1304,-1976,0
485,46127,"Union County, SD",7596,2782,4698,7897,2227,5290,-1916,-3063,0
486,46129,"Walworth County, SD",2462,671,1731,2477,457,1896,-1060,-1439,0
487,46135,"Yankton County, SD",9924,4208,5463,9623,3301,5659,-1255,-2358,0
488,46137,"Ziebach County, SD",761,439,314,767,353,368,125,-15,1
489,35001,"Bernalillo County, NM",264942,147183,104242,274662,143417,94698,42941,48719,0
490,35003,"Catron County, NM",2100,557,1474,2049,427,1464,-917,-1037,0
491,35005,"Chaves County, NM",20498,6621,13271,20271,5534,12872,-6650,-7338,0
492,35006,"Cibola County, NM",8154,4907,2966,8063,3741,3195,1941,546,0
493,35007,"Colfax County, NM",5896,2879,2763,5332,2129,2585,116,-456,1
494,35009,"Curry County, NM",13450,3956,9150,13370,3121,9035,-5194,-5914,0
495,35011,"De Baca County, NM",900,287,586,910,193,620,-299,-427,0
496,35013,"Dona Ana County, NM",65712,36778,26988,70648,37947,25374,9790,12573,0
497,35015,"Eddy County, NM",19195,6110,12546,19667,5033,13147,-6436,-8114,0
498,35017,"Grant County, NM",12744,7009,5286,12811,6276,5288,1723,988,0
499,35019,"Guadalupe County, NM",1978,1388,518,1827,970,595,870,375,0
500,35021,"Harding County, NM",600,260,326,527,156,311,-66,-155,0
501,35023,"Hidalgo County, NM",1929,994,895,1872,784,910,99,-126,1
502,35025,"Lea County, NM",16933,4068,12480,17712,3930,12495,-8412,-8565,0
503,35027,"Lincoln County, NM",9209,2931,5940,8902,2331,5896,-3009,-3565,0
504,35028,"Los Alamos County, NM",10654,5191,4796,10885,5562,3359,395,2203,0
505,35029,"Luna County, NM",7472,3573,3654,7295,3195,3478,-81,-283,0
506,35031,"McKinley County, NM",21313,15363,5420,21703,13576,5104,9943,8472,0
507,35033,"Mora County, NM",2604,1952,591,2441,1536,665,1361,871,0
508,35035,"Otero County, NM",19643,6715,12219,20060,6124,11887,-5504,-5763,0
509,35037,"Quay County, NM",3696,1382,2194,3572,1017,2212,-812,-1195,0
510,35039,"Rio Arriba County, NM",15239,11389,3373,14878,9592,3599,8016,5993,0
511,35041,"Roosevelt County, NM",5949,1719,4032,5950,1454,3884,-2313,-2430,0
512,35045,"San Juan County, NM",45994,15688,28779,46110,12865,27946,-13091,-15081,0
513,35047,"San Miguel County, NM",11388,8754,2281,10751,7285,2313,6473,4972,0
514,35043,"Sandoval County, NM",53361,26831,24124,61690,27707,25905,2707,1802,0
515,35049,"Santa Fe County, NM",67624,49668,15145,71434,50793,14332,34523,36461,0
516,35051,"Sierra County, NM",5101,1963,2928,5181,1612,3010,-965,-1398,0
517,35053,"Socorro County, NM",7087,3983,2698,6868,3313,2616,1285,697,0
518,35055,"Taos County, NM",15188,11855,2710,15260,10668,2727,9145,7941,0
519,35057,"Torrance County, NM",6376,2414,3521,6324,1785,3714,-1107,-1929,0
520,35059,"Union County, NM",1753,471,1231,1702,320,1216,-760,-896,0
521,35061,"Valencia County, NM",27647,13473,12788,27592,10841,13215,685,-2374,1
522,6001,"Alameda County, CA",577270,454344,106324,659543,514842,95922,348020,418920,0
523,6003,"Alpine County, CA",647,389,236,602,334,217,153,117,0
524,6005,"Amador County, CA",15303,6001,8903,17963,6004,10485,-2902,-4481,0
525,6007,"Butte County, CA",70163,32567,35312,97002,41567,45144,-2745,-3577,0
526,6009,"Calaveras County, CA",18469,7404,10537,23531,7944,13511,-3133,-5567,0
527,6011,"Colusa County, CA",5865,2248,3521,6697,2661,3551,-1273,-890,0
528,6013,"Contra Costa County, CA",364315,239198,116867,473014,319287,115956,122331,203331,0
529,6015,"Del Norte County, CA",7940,3396,4256,9558,3485,5134,-860,-1649,0
530,6017,"El Dorado County, CA",85923,34033,49661,95149,36404,49247,-15628,-12843,0
531,6019,"Fresno County, CA",180244,85862,91143,287062,141341,124049,-5281,17292,0
532,6021,"Glenn County, CA",9142,3276,5608,9470,3065,5788,-2332,-2723,0
533,6023,"Humboldt County, CA",46269,27757,15653,60014,33200,18373,12104,14827,0
534,6025,"Imperial County, CA",27453,17464,9545,48091,32667,12704,7919,19963,0
535,6027,"Inyo County, CA",6501,2775,3541,8179,3155,4248,-766,-1093,0
536,6029,"Kern County, CA",203831,80257,119065,244163,98689,129584,-38808,-30895,0
537,6031,"Kings County, CA",30139,12282,17184,34310,13617,18093,-4902,-4476,0
538,6033,"Lake County, CA",16274,9159,6474,24675,11496,10599,2685,897,0
539,6035,"Lassen County, CA",10603,3044,7261,10699,2224,7574,-4217,-5350,0
540,6037,"Los Angeles County, CA",2596915,1781383,754974,3434308,2464364,769743,1026409,1694621,0
541,6039,"Madera County, CA",32372,12698,18990,43507,17029,23357,-6292,-6328,0
542,6041,"Marin County, CA",99286,73450,23347,140683,108707,21771,50103,86936,0
543,6043,"Mariposa County, CA",7805,3080,4434,8877,3122,5185,-1354,-2063,0
544,6045,"Mendocino County, CA",17928,11869,5129,37915,22079,10888,6740,11191,0
545,6047,"Merced County, CA",50538,26128,23403,70789,37317,28725,2725,8592,0
546,6049,"Modoc County, CA",3986,1113,2779,3843,877,2696,-1666,-1819,0
547,6051,"Mono County, CA",4917,2574,2202,5281,2773,2111,372,662,0
548,6053,"Monterey County, CA",78522,51712,25087,133408,89088,34895,26625,54193,0
549,6055,"Napa County, CA",32332,19964,11647,61372,39199,17411,8317,21788,0
550,6057,"Nevada County, CA",30864,14261,15696,54935,26053,23365,-1435,2688,0
551,6059,"Orange County, CA",1021315,457077,541592,1197521,609961,507148,-84515,102813,0
552,6061,"Placer County, CA",126325,49126,74460,186024,73509,95138,-25334,-21629,0
553,6063,"Plumas County, CA",9128,3670,5240,9850,3459,5420,-1570,-1961,0
554,6065,"Riverside County, CA",589721,287754,290227,751391,373695,333243,-2473,40452,0
555,6067,"Sacramento County, CA",439670,251365,177523,562285,326023,189789,73842,136234,0
556,6069,"San Benito County, CA",14972,8617,6052,22122,12521,7841,2565,4680,0
557,6071,"San Bernardino County, CA",531692,274203,245468,653983,340833,271240,28735,69593,0
558,6073,"San Diego County, CA",976087,502937,453166,1306400,735476,477766,49771,257710,0
559,6075,"San Francisco County, CA",337111,281226,44877,408541,345084,37688,236349,307396,0
560,6077,"San Joaquin County, CA",181088,98746,78794,227002,121124,88936,19952,32188,0
561,6079,"San Luis Obispo County, CA",117597,57655,56500,137202,67107,56164,1155,10943,0
562,6081,"San Mateo County, CA",211814,151036,56244,314384,237882,57929,94792,179953,0
563,6083,"Santa Barbara County, CA",147249,84279,59096,178878,107142,56365,25183,50777,0
564,6085,"Santa Clara County, CA",491687,343239,136347,703709,511684,144826,206892,366858,0
565,6087,"Santa Cruz County, CA",81294,61106,17132,130012,95249,22438,43974,72811,0
566,6089,"Shasta County, CA",71331,24199,45158,81024,22301,51778,-20959,-29477,0
567,6091,"Sierra County, CA",1779,652,1056,1858,601,1048,-404,-447,0
568,6093,"Siskiyou County, CA",17505,7110,9844,20493,7234,11341,-2734,-4107,0
569,6095,"Solano County, CA",138565,87225,48364,168150,102360,51920,38861,50440,0
570,6097,"Sonoma County, CA",175738,124504,45666,233303,160435,51408,78838,109027,0
571,6099,"Stanislaus County, CA",143620,70609,69549,174406,81647,78494,1060,3153,0
572,6101,"Sutter County, CA",20988,8004,12576,33824,13076,18176,-4572,-5100,0
573,6103,"Tehama County, CA",17356,6032,10791,23908,6809,15494,-4759,-8685,0
574,6105,"Trinity County, CA",5030,2367,2422,5784,2214,2812,-55,-598,0
575,6107,"Tulare County, CA",72832,29191,42186,114102,47585,58299,-12995,-10714,0
576,6109,"Tuolumne County, CA",23730,9628,13410,25893,9123,14551,-3782,-5428,0
577,6111,"Ventura County, CA",286142,148006,131782,356107,194402,132323,16224,62079,0
578,6113,"Yolo County, CA",59613,38856,19080,82090,54752,20739,19776,34013,0
579,6115,"Yuba County, CA",15009,5817,8746,22998,7910,13170,-2929,-5260,0
580,13001,"Appling County, GA",7079,1756,5231,7012,1434,5494,-3475,-4060,0
581,13003,"Atkinson County, GA",2902,930,1938,2610,697,1878,-1008,-1181,0
582,13005,"Bacon County, GA",3929,791,3092,4020,608,3364,-2301,-2756,0
583,13007,"Baker County, GA",1584,790,784,1440,650,775,6,-125,1
584,13009,"Baldwin County, GA",16214,8469,7585,16116,7970,7697,884,273,0
585,13011,"Banks County, GA",6191,779,5353,6975,684,6134,-4574,-5450,0
586,13013,"Barrow County, GA",25171,6019,18719,29061,6580,21108,-12700,-14528,0
587,13015,"Bartow County, GA",35738,8383,26847,39733,8212,29911,-18464,-21699,0
588,13017,"Ben Hill County, GA",5947,2508,3395,5936,2101,3739,-887,-1638,0
589,13019,"Berrien County, GA",6187,1268,4837,6590,1047,5422,-3569,-4375,0
590,13021,"Bibb County, GA",64625,38538,25606,62596,36787,24043,12932,12744,0
591,13023,"Bleckley County, GA",4903,1266,3586,4974,1101,3719,-2320,-2618,0
592,13025,"Brantley County, GA",6001,939,4963,6301,619,5567,-4024,-4948,0
593,13027,"Brooks County, GA",6671,3101,3522,6336,2528,3701,-421,-1173,0
594,13029,"Bryan County, GA",13403,3695,9537,15173,4014,10529,-5842,-6515,0
595,13031,"Bulloch County, GA",24032,9572,14159,25316,9261,15097,-4587,-5836,0
596,13033,"Burke County, GA",9773,5403,4298,9351,4731,4491,1105,240,0
597,13035,"Butts County, GA",9372,2966,6306,9514,2566,6717,-3340,-4151,0
598,13037,"Calhoun County, GA",2187,1297,883,2025,1179,830,414,349,0
599,13039,"Camden County, GA",17938,6358,11318,19069,5930,12310,-4960,-6380,0
600,13043,"Candler County, GA",3526,1155,2344,3763,1026,2664,-1189,-1638,0
601,13045,"Carroll County, GA",41445,12635,28249,44459,12464,30029,-15614,-17565,0
602,13047,"Catoosa County, GA",23639,5357,17848,26940,4771,20876,-12491,-16105,0
603,13049,"Charlton County, GA",3763,1197,2527,4016,1004,2951,-1330,-1947,0
604,13051,"Chatham County, GA",108267,60077,47083,113051,62290,45688,12994,16602,0
605,13053,"Chattahoochee County, GA",1483,726,732,1390,594,751,-6,-157,0
606,13055,"Chattooga County, GA",7791,2220,5434,8252,1613,6462,-3214,-4849,0
607,13057,"Cherokee County, GA",98041,19813,76473,112784,25231,80649,-56660,-55418,0
608,13059,"Clarke County, GA",40138,25386,13804,45476,29603,12717,11582,16886,0
609,13061,"Clay County, GA",1402,862,537,1273,697,566,325,131,0
610,13063,"Clayton County, GA",96020,81439,14158,93580,78220,12645,67281,65575,0
611,13065,"Clinch County, GA",2472,852,1598,2455,686,1727,-746,-1041,0
612,13067,"Cobb County, GA",308989,132526,171464,334058,160121,152912,-38938,7209,0
613,13069,"Coffee County, GA",14434,5048,9242,13915,4094,9588,-4194,-5494,0
614,13071,"Colquitt County, GA",13319,3971,9240,13624,3463,9898,-5269,-6435,0
615,13073,"Columbia County, GA",58842,16420,41724,65207,18887,43085,-25304,-24198,0
616,13075,"Cook County, GA",6027,2042,3934,6057,1753,4176,-1892,-2423,0
617,13077,"Coweta County, GA",55512,15156,39633,62210,16583,42533,-24477,-25950,0
618,13079,"Crawford County, GA",5123,1699,3366,5176,1421,3635,-1667,-2214,0
619,13081,"Crisp County, GA",7386,3160,4179,7512,2837,4549,-1019,-1712,0
620,13083,"Dade County, GA",5997,1404,4458,6242,965,5051,-3054,-4086,0
621,13085,"Dawson County, GA",10234,1241,8843,11820,1448,9900,-7602,-8452,0
622,13087,"Decatur County, GA",10465,4580,5816,10286,4124,6020,-1236,-1896,0
623,13089,"DeKalb County, GA",305299,237704,64308,317849,251370,51468,173396,199902,0
624,13091,"Dodge County, GA",7731,2440,5214,7009,1839,5021,-2774,-3182,0
625,13093,"Dooly County, GA",4289,2278,1983,3859,1872,1951,295,-79,1
626,13095,"Dougherty County, GA",37822,26209,11441,34087,23311,10232,14768,13079,0
627,13097,"Douglas County, GA",55201,28410,26226,57738,31005,24817,2184,6188,0
628,13099,"Early County, GA",5349,2762,2556,4785,2168,2552,206,-384,1
629,13101,"Echols County, GA",1102,173,917,1182,156,1007,-744,-851,0
630,13103,"Effingham County, GA",20779,4941,15591,23458,4853,17874,-10650,-13021,0
631,13105,"Elbert County, GA",8139,3179,4857,7987,2539,5292,-1678,-2753,0
632,13107,"Emanuel County, GA",8060,2919,5086,7860,2435,5335,-2167,-2900,0
633,13109,"Evans County, GA",3560,1266,2267,3613,1130,2404,-1001,-1274,0
634,13111,"Fannin County, GA",10007,2027,7853,11876,1923,9632,-5826,-7709,0
635,13113,"Fayette County, GA",58473,19703,38046,61511,23284,35048,-18343,-11764,0
636,13115,"Floyd County, GA",32685,9595,22636,34860,9159,24114,-13041,-14955,0
637,13117,"Forsyth County, GA",81598,14544,65853,98964,23462,69851,-51309,-46389,0
638,13119,"Franklin County, GA",7757,1499,6112,8550,1243,7054,-4613,-5811,0
639,13121,"Fulton County, GA",386845,248479,133837,438751,297051,117783,114642,179268,0
640,13123,"Gilmer County, GA",11008,1955,8920,12773,1965,10477,-6965,-8512,0
641,13125,"Glascock County, GA",1333,176,1135,1390,138,1235,-959,-1097,0
642,13127,"Glynn County, GA",33054,11922,20853,34437,11775,21512,-8931,-9737,0
643,13129,"Gordon County, GA",16857,3436,13174,19062,3181,15191,-9738,-12010,0
644,13131,"Grady County, GA",9391,3419,5922,9213,3013,6053,-2503,-3040,0
645,13133,"Greene County, GA",8313,3195,5067,8852,3199,5490,-1872,-2291,0
646,13135,"Gwinnett County, GA",295560,131879,159563,330950,166153,146989,-27684,19164,0
647,13137,"Habersham County, GA",14600,2297,12148,16333,2483,13190,-9851,-10707,0
648,13139,"Hall County, GA",59241,12489,45918,71142,16180,51733,-33429,-35553,0
649,13141,"Hancock County, GA",4076,3301,764,3580,2701,843,2537,1858,0
650,13143,"Haralson County, GA",10362,1787,8439,11357,1475,9585,-6652,-8110,0
651,13145,"Harris County, GA",15479,4141,11193,16502,4086,11936,-7052,-7850,0
652,13147,"Hart County, GA",9501,2869,6516,10117,2585,7286,-3647,-4701,0
653,13149,"Heard County, GA",4162,947,3155,4223,743,3370,-2208,-2627,0
654,13151,"Henry County, GA",90469,43374,46299,99367,50057,45724,-2925,4333,0
655,13153,"Houston County, GA",57912,22643,34631,60079,22553,35430,-11988,-12877,0
656,13155,"Irwin County, GA",3683,1134,2519,3670,891,2716,-1385,-1825,0
657,13157,"Jackson County, GA",23670,4236,19122,27421,4491,21784,-14886,-17293,0
658,13159,"Jasper County, GA",6010,1839,4121,6045,1544,4360,-2282,-2816,0
659,13161,"Jeff Davis County, GA",5330,1271,3994,5096,901,4104,-2723,-3203,0
660,13163,"Jefferson County, GA",7268,4238,2992,6968,3821,3063,1246,758,0
661,13165,"Jenkins County, GA",3386,1487,1884,3056,1123,1895,-397,-772,0
662,13167,"Johnson County, GA",3772,1305,2440,3686,1136,2519,-1135,-1383,0
663,13169,"Jones County, GA",12099,4272,7740,12551,3961,8305,-3468,-4344,0
664,13171,"Lamar County, GA",7589,2602,4896,7612,2270,5190,-2294,-2920,0
665,13173,"Lanier County, GA",2958,1108,1812,2871,806,1984,-704,-1178,0
666,13175,"Laurens County, GA",19591,7508,11947,19530,6752,12411,-4439,-5659,0
667,13177,"Lee County, GA",13607,3187,10310,14143,3170,10646,-7123,-7476,0
668,13179,"Liberty County, GA",16132,10427,5558,16143,9556,6134,4869,3422,0
669,13181,"Lincoln County, GA",4425,1586,2806,4102,1273,2759,-1220,-1486,0
670,13183,"Long County, GA",3786,1434,2300,4117,1360,2626,-866,-1266,0
671,13185,"Lowndes County, GA",38610,17118,21176,37805,15064,21635,-4058,-6571,0
672,13187,"Lumpkin County, GA",10878,2049,8633,12517,2220,9619,-6584,-7399,0
673,13193,"Macon County, GA",4781,3211,1545,4287,2705,1540,1666,1165,0
674,13195,"Madison County, GA",11079,2486,8441,12081,2425,9201,-5955,-6776,0
675,13197,"Marion County, GA",3167,1411,1731,3190,1213,1921,-320,-708,0
676,13189,"McDuffie County, GA",9585,4041,5475,9268,3699,5432,-1434,-1733,0
677,13191,"McIntosh County, GA",6333,2860,3405,5903,2303,3487,-545,-1184,0
678,13199,"Meriwether County, GA",9259,4328,4855,9217,3804,5222,-527,-1418,0
679,13201,"Miller County, GA",2770,848,1904,2544,623,1891,-1056,-1268,0
680,13205,"Mitchell County, GA",8273,4081,4153,7880,3493,4279,-72,-786,0
681,13207,"Monroe County, GA",12259,3779,8352,12687,3571,8832,-4573,-5261,0
682,13209,"Montgomery County, GA",3831,1135,2662,3576,847,2670,-1527,-1823,0
683,13211,"Morgan County, GA",9016,2751,6178,9475,2663,6559,-3427,-3896,0
684,13213,"Murray County, GA",11209,2542,8439,12458,1800,10341,-5897,-8541,0
685,13215,"Muscogee County, GA",70410,42458,27469,69525,39851,26976,14989,12875,0
686,13217,"Newton County, GA",43216,21844,20979,44238,21943,20913,865,1030,0
687,13219,"Oconee County, GA",16643,4140,12222,20149,5581,13425,-8082,-7844,0
688,13221,"Oglethorpe County, GA",6258,1913,4250,6674,1831,4625,-2337,-2794,0
689,13223,"Paulding County, GA",57254,15779,40771,65478,18025,44662,-24992,-26637,0
690,13225,"Peach County, GA",11499,6141,5280,10752,5100,5413,861,-313,1
691,13227,"Pickens County, GA",12673,1975,10547,14058,1979,11651,-8572,-9672,0
692,13229,"Pierce County, GA",6845,1124,5666,7311,903,6302,-4542,-5399,0
693,13231,"Pike County, GA",8099,1355,6660,8725,1240,7278,-5305,-6038,0
694,13233,"Polk County, GA",13580,3608,9798,14215,2867,11014,-6190,-8147,0
695,13235,"Pulaski County, GA",3681,1219,2444,3605,1104,2437,-1225,-1333,0
696,13237,"Putnam County, GA",9205,2917,6210,9488,2758,6544,-3293,-3786,0
697,13239,"Quitman County, GA",1128,612,510,1044,461,575,102,-114,1
698,13241,"Rabun County, GA",7438,1558,5753,7992,1444,6287,-4195,-4843,0
699,13243,"Randolph County, GA",3015,1749,1249,2899,1598,1271,500,327,0
700,13245,"Richmond County, GA",78865,52461,25821,76025,48814,24461,26640,24353,0
701,13247,"Rockdale County, GA",37879,21878,15671,38087,23255,13478,6207,9777,0
702,13249,"Schley County, GA",1748,448,1286,1909,401,1472,-838,-1071,0
703,13251,"Screven County, GA",6093,2769,3285,5715,2300,3305,-516,-1005,0
704,13253,"Seminole County, GA",3765,1475,2244,3588,1189,2345,-769,-1156,0
705,13255,"Spalding County, GA",25057,9884,14901,25704,9357,15646,-5017,-6289,0
706,13257,"Stephens County, GA",9467,2123,7207,9815,1837,7686,-5084,-5849,0
707,13259,"Stewart County, GA",2055,1307,740,2058,1222,805,567,417,0
708,13261,"Sumter County, GA",11820,6370,5372,10974,5520,5276,998,244,0
709,13263,"Talbot County, GA",3490,2264,1202,3246,2002,1196,1062,806,0
710,13265,"Taliaferro County, GA",961,636,321,897,545,349,315,196,0
711,13267,"Tattnall County, GA",6658,1894,4702,6903,1681,5096,-2808,-3415,0
712,13269,"Taylor County, GA",3537,1571,1948,3408,1296,2064,-377,-768,0
713,13271,"Telfair County, GA",4334,1804,2479,3796,1313,2450,-675,-1137,0
714,13273,"Terrell County, GA",4398,2544,1834,4189,2267,1874,710,393,0
715,13275,"Thomas County, GA",18943,7651,11153,18802,7142,11228,-3502,-4086,0
716,13277,"Tift County, GA",13893,4640,9171,14219,4347,9584,-4531,-5237,0
717,13279,"Toombs County, GA",9333,2740,6519,9138,2338,6615,-3779,-4277,0
718,13281,"Towns County, GA",6159,1265,4834,6764,1210,5383,-3569,-4173,0
719,13283,"Treutlen County, GA",2738,1068,1646,2703,862,1809,-578,-947,0
720,13285,"Troup County, GA",25975,10545,15170,26111,9713,15750,-4625,-6037,0
721,13287,"Turner County, GA",3556,1508,2027,3398,1246,2095,-519,-849,0
722,13289,"Twiggs County, GA",4199,2269,1905,4059,1971,2035,364,-64,1
723,13291,"Union County, GA",11072,2137,8771,12063,1963,9852,-6634,-7889,0
724,13293,"Upson County, GA",11257,3955,7229,10934,3475,7292,-3274,-3817,0
725,13295,"Walker County, GA",21879,5269,16245,23956,4215,18950,-10976,-14735,0
726,13297,"Walton County, GA",37570,8139,29018,40698,8292,31125,-20879,-22833,0
727,13299,"Ware County, GA",11923,3892,7933,12184,3440,8513,-4041,-5073,0
728,13301,"Warren County, GA",2522,1525,990,2334,1314,991,535,323,0
729,13303,"Washington County, GA",8796,4705,4033,8461,4200,4149,672,51,0
730,13305,"Wayne County, GA",10258,2594,7553,10413,2041,8153,-4959,-6112,0
731,13307,"Webster County, GA",1175,573,598,1116,473,630,-25,-157,0
732,13309,"Wheeler County, GA",2160,772,1366,2102,646,1421,-594,-775,0
733,13311,"White County, GA",10471,1670,8647,11912,1674,9761,-6977,-8087,0
734,13313,"Whitfield County, GA",26828,7193,19290,30658,7937,21537,-12097,-13600,0
735,13315,"Wilcox County, GA",3124,1059,2050,2976,852,2096,-991,-1244,0
736,13317,"Wilkes County, GA",4746,2080,2628,4486,1848,2572,-548,-724,0
737,13319,"Wilkinson County, GA",4448,2180,2245,4287,1894,2333,-65,-439,0
738,13321,"Worth County, GA",8410,2486,5864,8295,2020,6152,-3378,-4132,0
739,32510,"Carson City, NV",23318,10290,12394,25016,9610,13125,-2104,-3515,0
740,32001,"Churchill County, NV",10265,2961,7061,10938,2210,7830,-4100,-5620,0
741,32003,"Clark County, NV",688339,387978,288223,767156,402227,320057,99755,82170,0
742,32005,"Douglas County, NV",26054,9288,16264,27885,8454,17415,-6976,-8961,0
743,32007,"Elko County, NV",15984,3510,12013,18559,3401,13551,-8503,-10150,0
744,32009,"Esmeralda County, NV",435,92,317,423,65,329,-225,-264,0
745,32011,"Eureka County, NV",808,107,663,854,74,723,-556,-649,0
746,32013,"Humboldt County, NV",5744,1737,3810,6433,1386,4521,-2073,-3135,0
747,32015,"Lander County, NV",2165,534,1580,2413,403,1828,-1046,-1425,0
748,32017,"Lincoln County, NV",2152,400,1691,2132,285,1671,-1291,-1386,0
749,32019,"Lyon County, NV",21465,7380,13520,23762,6146,16005,-6140,-9859,0
750,32021,"Mineral County, NV",2035,863,1080,1997,637,1179,-217,-542,0
751,32023,"Nye County, NV",17522,6320,10566,19595,5094,13324,-4246,-8230,0
752,32027,"Pershing County, NV",1884,632,1167,1982,430,1403,-535,-973,0
753,32029,"Storey County, NV",2314,920,1321,2558,752,1616,-401,-864,0
754,32031,"Washoe County, NV",186917,94806,88151,209909,97379,94758,6655,2621,0
755,32033,"White Pine County, NV",3704,983,2601,3773,707,2723,-1618,-2016,0
756,50001,"Addison County, VT",17843,12290,5214,19031,11219,5297,7076,5922,0
757,50003,"Bennington County, VT",17512,11517,5687,17381,9539,5925,5830,3614,0
758,50005,"Caledonia County, VT",13545,8192,5088,14074,6445,5534,3104,911,0
759,50007,"Chittenden County, VT",76531,53615,21567,83416,54814,18601,32048,36213,0
760,50009,"Essex County, VT",2769,1539,1169,2925,1019,1506,370,-487,1
761,50011,"Franklin County, VT",19755,12057,7405,21411,9351,8752,4652,599,0
762,50013,"Grand Isle County, VT",4064,2531,1471,4109,2094,1487,1060,607,0
763,50015,"Lamoille County, VT",11924,8371,3352,12762,7241,3570,5019,3671,0
764,50017,"Orange County, VT",13964,9075,4588,14649,7541,5007,4487,2534,0
765,50019,"Orleans County, VT",11631,7116,4306,12046,5185,5159,2810,26,0
766,50021,"Rutland County, VT",28414,17087,10834,29615,13635,12479,6253,1156,0
767,50023,"Washington County, VT",29049,20349,8092,31086,18594,7993,12257,10601,0
768,50025,"Windham County, VT",21805,16080,5344,22634,14340,5454,10736,8886,0
769,50027,"Windsor County, VT",28468,19440,8583,29928,17556,8605,10857,8951,0
770,12001,"Alachua County, FL",120318,69634,48765,130100,75820,46834,20869,28986,0
771,12003,"Baker County, FL",11366,2310,8974,12705,2112,10294,-6664,-8182,0
772,12005,"Bay County, FL",79834,22037,56863,88222,21797,62194,-34826,-40397,0
773,12007,"Bradford County, FL",11631,3324,8216,12158,2924,8913,-4892,-5989,0
774,12009,"Brevard County, FL",285504,122972,159270,318141,119679,181848,-36298,-62169,0
775,12011,"Broward County, FL",755166,507430,243732,837388,553320,260951,263698,292369,0
776,12013,"Calhoun County, FL",6152,1664,4366,6128,1241,4655,-2702,-3414,0
777,12015,"Charlotte County, FL",84664,35896,47988,97187,33445,60218,-12092,-26773,0
778,12017,"Citrus County, FL",73923,28453,44657,80412,22789,54456,-16204,-31667,0
779,12019,"Clay County, FL",96549,25745,69996,107317,27822,74963,-44251,-47141,0
780,12021,"Collier County, FL",149080,51678,96508,172510,61085,105423,-44830,-44338,0
781,12023,"Columbia County, FL",27163,8462,18429,28864,7601,20368,-9967,-12767,0
782,12027,"DeSoto County, FL",9863,4174,5587,10903,3781,6778,-1413,-2997,0
783,12029,"Dixie County, FL",6941,1798,5052,7246,1270,5822,-3254,-4552,0
784,12031,"Duval County, FL",411702,196657,211553,436573,205704,211672,-14896,-5968,0
785,12033,"Escambia County, FL",148430,58154,88671,154172,57461,88808,-30517,-31347,0
786,12035,"Flagler County, FL",50589,23204,26966,57987,22026,33850,-3762,-11824,0
787,12037,"Franklin County, FL",5474,1845,3570,6059,1744,4125,-1725,-2381,0
788,12039,"Gadsden County, FL",22495,15768,6628,22214,15020,6728,9140,8292,0
789,12041,"Gilchrist County, FL",7908,1885,5917,8472,1458,6740,-4032,-5282,0
790,12043,"Glades County, FL",3989,1603,2344,4382,1271,2996,-741,-1725,0
791,12045,"Gulf County, FL",7107,2013,4995,7331,1720,5329,-2982,-3609,0
792,12047,"Hamilton County, FL",5404,2226,3137,5491,1904,3443,-911,-1539,0
793,12049,"Hardee County, FL",7222,2461,4694,7645,2149,5242,-2233,-3093,0
794,12051,"Hendry County, FL",10185,4751,5355,11182,4615,6195,-604,-1580,0
795,12053,"Hernando County, FL",83593,37791,44906,94651,31795,58970,-7115,-27175,0
796,12055,"Highlands County, FL",42440,16147,25912,46011,14937,29565,-9765,-14628,0
797,12057,"Hillsborough County, FL",541503,286158,249904,603890,307896,266870,36254,41026,0
798,12059,"Holmes County, FL",8274,1264,6919,8556,853,7483,-5655,-6630,0
799,12061,"Indian River County, FL",71445,27483,43441,80769,29043,48620,-15958,-19577,0
800,12063,"Jackson County, FL",20940,7342,13417,21159,6397,14257,-6075,-7860,0
801,12065,"Jefferson County, FL",7808,3945,3808,7689,3541,3930,137,-389,1
802,12067,"Lafayette County, FL",3399,687,2668,3411,518,2809,-1981,-2291,0
803,12069,"Lake County, FL",150796,61790,87637,170462,62838,102188,-25847,-39350,0
804,12071,"Lee County, FL",266034,110080,154112,329762,124908,191551,-44032,-66643,0
805,12073,"Leon County, FL",148335,90863,55806,153881,92068,53821,35057,38247,0
806,12075,"Levy County, FL",18396,6118,12052,19499,5101,13775,-5934,-8674,0
807,12077,"Liberty County, FL",3284,942,2301,3312,651,2543,-1359,-1892,0
808,12079,"Madison County, FL",8712,4174,4474,8540,3526,4851,-300,-1325,0
809,12081,"Manatee County, FL",153451,66476,85616,180757,71224,101944,-19140,-30720,0
810,12083,"Marion County, FL",161368,66823,93036,175900,62041,107833,-26213,-45792,0
811,12085,"Martin County, FL",78860,30097,48180,86633,30185,53204,-18083,-23019,0
812,12086,"Miami-Dade County, FL",877245,540776,332602,987191,624146,333999,208174,290147,0
813,12087,"Monroe County, FL",39045,19392,19234,42977,18971,21904,158,-2933,1
814,12089,"Nassau County, FL",40523,10249,29926,46992,10869,34266,-19677,-23397,0
815,12091,"Okaloosa County, FL",94739,23390,70143,102096,23780,71893,-46753,-48113,0
816,12093,"Okeechobee County, FL",12321,4856,7325,13761,3959,9356,-2469,-5397,0
817,12095,"Orange County, FL",467385,274227,189057,551902,329894,195216,85170,134678,0
818,12097,"Osceola County, FL",108647,67201,40581,141467,85458,50301,26620,35157,0
819,12099,"Palm Beach County, FL",600341,349418,247257,666212,374673,272402,102161,102271,0
820,12101,"Pasco County, FL",213358,98148,112335,243265,90142,142101,-14187,-51959,0
821,12103,"Pinellas County, FL",457484,238966,213192,497485,233701,239201,25774,-5500,1
822,12105,"Polk County, FL",248658,114610,131566,286969,117433,157430,-16956,-39997,0
823,12107,"Putnam County, FL",31323,11666,19326,33301,10094,22138,-7660,-12044,0
824,12113,"Santa Rosa County, FL",76816,17757,58169,88684,18464,65339,-40412,-46875,0
825,12115,"Sarasota County, FL",207434,95089,110489,231353,97870,124438,-15400,-26568,0
826,12117,"Seminole County, FL",208605,96435,109939,227526,105914,109443,-13504,-3529,0
827,12109,"St. Johns County, FL",114733,35155,78490,137846,43099,88684,-43335,-45585,0
828,12111,"St. Lucie County, FL",123026,65869,56202,141993,66881,70289,9667,-3408,1
829,12119,"Sumter County, FL",60471,19519,40644,77238,22638,52730,-21125,-30092,0
830,12121,"Suwannee County, FL",17627,4749,12672,18787,3964,14287,-7923,-10323,0
831,12123,"Taylor County, FL",9117,2761,6249,9348,2152,6930,-3488,-4778,0
832,12125,"Union County, FL",5393,1339,3980,5722,1014,4568,-2641,-3554,0
833,12127,"Volusia County, FL",234483,114716,117473,263278,109091,143007,-2757,-33916,0
834,12129,"Wakulla County, FL",14656,5173,9288,15444,4348,10512,-4115,-6164,0
835,12131,"Walton County, FL",28480,6665,21483,33898,6876,25756,-14818,-18880,0
836,12133,"Washington County, FL",10998,2820,8037,11211,2264,8637,-5217,-6373,0
837,28001,"Adams County, MS",13621,7999,5542,13836,7757,5874,2457,1883,0
838,28003,"Alcorn County, MS",14682,3449,11027,14783,2684,11819,-7578,-9135,0
839,28005,"Amite County, MS",7661,3218,4393,7050,2697,4289,-1175,-1592,0
840,28007,"Attala County, MS",7853,3368,4452,8256,3242,4897,-1084,-1655,0
841,28009,"Benton County, MS",4080,2026,2030,4022,1719,2251,-4,-532,0
842,28011,"Bolivar County, MS",14258,9772,4346,13824,9046,4590,5426,4456,0
843,28013,"Calhoun County, MS",6273,2250,3961,6396,1910,4390,-1711,-2480,0
844,28015,"Carroll County, MS",5968,1990,3953,5528,1680,3799,-1963,-2119,0
845,28017,"Chickasaw County, MS",7641,3914,3601,7890,3649,4127,313,-478,1
846,28019,"Choctaw County, MS",3847,1283,2533,4065,1218,2788,-1250,-1570,0
847,28021,"Claiborne County, MS",5258,4633,608,4272,3708,540,4025,3168,0
848,28023,"Clarke County, MS",7199,2695,4415,7791,2585,5137,-1720,-2552,0
849,28025,"Clay County, MS",9659,5860,3735,10003,5722,4150,2125,1572,0
850,28027,"Coahoma County, MS",9563,7164,2356,8912,6378,2426,4808,3952,0
851,28029,"Copiah County, MS",13002,7201,5714,12982,6741,6103,1487,638,0
852,28031,"Covington County, MS",9145,3800,5282,8811,3276,5435,-1482,-2159,0
853,28033,"DeSoto County, MS",64026,20979,42399,66155,20591,43089,-21420,-22498,0
854,28035,"Forrest County, MS",27789,12079,15339,28064,11716,15461,-3260,-3745,0
855,28037,"Franklin County, MS",4443,1706,2705,4290,1502,2721,-999,-1219,0
856,28039,"George County, MS",9826,1352,8353,9891,1027,8696,-7001,-7669,0
857,28041,"Greene County, MS",5919,1325,4528,5369,974,4335,-3203,-3361,0
858,28043,"Grenada County, MS",11320,5279,5980,10513,4424,5970,-701,-1546,0
859,28045,"Hancock County, MS",17023,3879,12859,17637,3344,13811,-8980,-10467,0
860,28047,"Harrison County, MS",61602,22242,38646,63313,21169,40354,-16404,-19185,0
861,28049,"Hinds County, MS",97639,70512,26450,95077,67594,25275,44062,42319,0
862,28051,"Holmes County, MS",8076,6775,1264,8076,6689,1309,5511,5380,0
863,28053,"Humphreys County, MS",4481,3399,1069,4253,3071,1151,2330,1920,0
864,28055,"Issaquena County, MS",787,479,302,699,395,298,177,97,0
865,28057,"Itawamba County, MS",8729,1599,6925,9737,1117,8470,-5326,-7353,0
866,28059,"Jackson County, MS",49290,15452,33262,49567,14657,33629,-17810,-18972,0
867,28061,"Jasper County, MS",9340,5097,4193,8475,4368,4038,904,330,0
868,28065,"Jefferson Davis County, MS",6618,4094,2439,6237,3720,2466,1655,1254,0
869,28063,"Jefferson County, MS",3953,3508,431,3860,3337,490,3077,2847,0
870,28067,"Jones County, MS",30038,9146,20635,28352,7791,20133,-11489,-12342,0
871,28069,"Kemper County, MS",5052,3239,1789,4639,2827,1778,1450,1049,0
872,28071,"Lafayette County, MS",17191,7098,9772,19643,7969,10872,-2674,-2903,0
873,28073,"Lamar County, MS",22780,5037,17472,24592,5190,18751,-12435,-13561,0
874,28075,"Lauderdale County, MS",30213,12642,17322,29506,11269,17741,-4680,-6472,0
875,28077,"Lawrence County, MS",6584,2394,4153,6364,2195,4091,-1759,-1896,0
876,28079,"Leake County, MS",7921,3599,4283,8449,3584,4782,-684,-1198,0
877,28081,"Lee County, MS",34363,12043,22004,32913,10029,22220,-9961,-12191,0
878,28083,"Leflore County, MS",11600,8423,3115,11140,7787,3212,5308,4575,0
879,28085,"Lincoln County, MS",14303,4879,9333,15193,4458,10550,-4454,-6092,0
880,28087,"Lowndes County, MS",24674,12037,12399,25695,11819,13271,-362,-1452,0
881,28089,"Madison County, MS",49571,20722,28507,50131,20343,28265,-7785,-7922,0
882,28091,"Marion County, MS",11041,3833,7118,11693,3677,7836,-3285,-4159,0
883,28093,"Marshall County, MS",16141,9581,6444,14839,8023,6587,3137,1436,0
884,28095,"Monroe County, MS",16789,6990,9661,15884,5524,10167,-2671,-4643,0
885,28097,"Montgomery County, MS",4807,2245,2543,4996,2115,2818,-298,-703,0
886,28099,"Neshoba County, MS",10890,3030,7772,10553,2715,7679,-4742,-4964,0
887,28101,"Newton County, MS",9039,3069,5909,9438,2756,6548,-2840,-3792,0
888,28103,"Noxubee County, MS",6264,4920,1325,5574,4347,1200,3595,3147,0
889,28105,"Oktibbeha County, MS",16001,8030,7728,18124,8859,8576,302,283,0
890,28107,"Panola County, MS",16826,9079,7629,15064,7431,7449,1450,-18,1
891,28109,"Pearl River County, MS",19938,3813,15836,21883,3604,17782,-12023,-14178,0
892,28111,"Perry County, MS",5686,1519,4110,5432,1220,4135,-2591,-2915,0
893,28113,"Pike County, MS",17429,9304,7986,16360,8043,8009,1318,34,0
894,28115,"Pontotoc County, MS",12348,2785,9403,12984,2386,10336,-6618,-7950,0
895,28117,"Prentiss County, MS",10033,2817,7075,9872,2067,7648,-4258,-5581,0
896,28119,"Quitman County, MS",3979,2837,1116,3365,2312,1001,1721,1311,0
897,28121,"Rankin County, MS",61438,14425,46318,63110,14110,47178,-31893,-33068,0
898,28123,"Scott County, MS",10584,4774,5728,10522,4268,6122,-954,-1854,0
899,28125,"Sharkey County, MS",2258,1571,675,2190,1479,692,896,787,0
900,28127,"Simpson County, MS",12249,4723,7424,11419,3874,7393,-2701,-3519,0
901,28129,"Smith County, MS",8099,1979,6049,7627,1617,5928,-4070,-4311,0
902,28131,"Stone County, MS",6820,1794,4924,7045,1573,5306,-3130,-3733,0
903,28133,"Sunflower County, MS",10995,7989,2907,9598,6725,2794,5082,3931,0
904,28135,"Tallahatchie County, MS",6363,3838,2480,5870,3337,2462,1358,875,0
905,28137,"Tate County, MS",11374,4572,6666,11627,3926,7495,-2094,-3569,0
906,28139,"Tippah County, MS",9008,2254,6625,9260,1842,7240,-4371,-5398,0
907,28141,"Tishomingo County, MS",7850,1623,6070,8371,999,7166,-4447,-6167,0
908,28143,"Tunica County, MS",4262,3371,867,3567,2667,853,2504,1814,0
909,28145,"Union County, MS",10359,2481,7759,11496,2012,9235,-5278,-7223,0
910,28147,"Walthall County, MS",7476,3386,4012,6919,2790,4056,-626,-1266,0
911,28149,"Warren County, MS",19429,9899,9390,19416,9284,9767,509,-483,1
912,28151,"Washington County, MS",17137,12188,4870,16825,11380,5244,7318,6136,0
913,28153,"Wayne County, MS",10269,4116,6080,9599,3524,5990,-1964,-2466,0
914,28155,"Webster County, MS",4820,1087,3684,5069,1019,3976,-2597,-2957,0
915,28157,"Wilkinson County, MS",4238,2940,1275,4218,2857,1318,1665,1539,0
916,28159,"Winston County, MS",9758,4557,5147,8881,3850,4910,-590,-1060,0
917,28161,"Yalobusha County, MS",6293,2984,3261,6077,2582,3376,-277,-794,0
918,28163,"Yazoo County, MS",10853,6220,4560,10070,5369,4598,1660,771,0
919,40001,"Adair County, OK",6472,2110,4362,6513,1382,4787,-2252,-3405,0
920,40003,"Alfalfa County, OK",1817,278,1539,2258,216,1933,-1261,-1717,0
921,40005,"Atoka County, OK",4775,1241,3534,5018,795,4084,-2293,-3289,0
922,40007,"Beaver County, OK",2300,243,2057,2243,176,1993,-1814,-1817,0
923,40009,"Beckham County, OK",6909,1413,5496,7552,960,6308,-4083,-5348,0
924,40011,"Blaine County, OK",3815,991,2824,3793,711,2884,-1833,-2173,0
925,40013,"Bryan County, OK",12721,3533,9188,13818,2804,10478,-5655,-7674,0
926,40015,"Caddo County, OK",8811,3151,5660,9348,2420,6482,-2509,-4062,0
927,40017,"Canadian County, OK",46148,10533,35615,55278,11674,39986,-25082,-28312,0
928,40019,"Carter County, OK",17120,4907,12213,18534,4002,13752,-7306,-9750,0
929,40021,"Cherokee County, OK",14288,6137,8151,16490,5456,9994,-2014,-4538,0
930,40023,"Choctaw County, OK",5066,1494,3572,5426,1067,4206,-2078,-3139,0
931,40025,"Cimarron County, OK",1197,115,1082,1079,71,963,-967,-892,0
932,40027,"Cleveland County, OK",93720,34701,59019,109450,38829,62538,-24318,-23709,0
933,40029,"Coal County, OK",2357,648,1709,2399,411,1898,-1061,-1487,0
934,40031,"Comanche County, OK",30174,12517,17657,32564,11463,19183,-5140,-7720,0
935,40033,"Cotton County, OK",2453,657,1796,2602,424,2054,-1139,-1630,0
936,40035,"Craig County, OK",5298,1746,3552,5785,1252,4283,-1806,-3031,0
937,40037,"Creek County, OK",26078,7114,18964,28830,5841,21575,-11850,-15734,0
938,40039,"Custer County, OK",9800,2358,7442,10541,2104,7826,-5084,-5722,0
939,40041,"Delaware County, OK",14232,4176,10056,15716,3311,11826,-5880,-8515,0
940,40043,"Dewey County, OK",2070,301,1769,2248,222,1965,-1468,-1743,0
941,40045,"Ellis County, OK",1801,226,1575,1827,155,1611,-1349,-1456,0
942,40047,"Garfield County, OK",19908,4732,15176,21710,4397,16009,-10444,-11612,0
943,40049,"Garvin County, OK",9478,2556,6922,10546,1855,8253,-4366,-6398,0
944,40051,"Grady County, OK",19598,4780,14818,22286,3882,17316,-10038,-13434,0
945,40053,"Grant County, OK",2067,393,1674,2201,288,1827,-1281,-1539,0
946,40055,"Greer County, OK",1832,488,1344,1896,323,1482,-856,-1159,0
947,40057,"Harmon County, OK",923,264,659,977,225,715,-395,-490,0
948,40059,"Harper County, OK",1434,173,1261,1499,134,1318,-1088,-1184,0
949,40061,"Haskell County, OK",4244,1175,3069,4738,882,3701,-1894,-2819,0
950,40063,"Hughes County, OK",4206,1370,2836,4526,961,3388,-1466,-2427,0
951,40065,"Jackson County, OK",7915,1953,5962,7806,1473,5969,-4009,-4496,0
952,40067,"Jefferson County, OK",2234,602,1632,2350,365,1910,-1030,-1545,0
953,40069,"Johnston County, OK",3778,1134,2644,4018,786,3093,-1510,-2307,0
954,40071,"Kay County, OK",16122,4624,11498,16803,3738,12172,-6874,-8434,0
955,40073,"Kingfisher County, OK",5354,844,4510,6131,786,5156,-3666,-4370,0
956,40075,"Kiowa County, OK",3410,1101,2309,3493,767,2596,-1208,-1829,0
957,40077,"Latimer County, OK",3789,1169,2620,4056,797,3100,-1451,-2303,0
958,40079,"Le Flore County, OK",15830,4658,11172,17221,3250,13362,-6514,-10112,0
959,40081,"Lincoln County, OK",12807,3265,9542,14025,2430,10854,-6277,-8424,0
960,40083,"Logan County, OK",16983,4686,12297,18979,4248,13633,-7611,-9385,0
961,40085,"Love County, OK",3470,1034,2436,3789,735,2922,-1402,-2187,0
962,40093,"Major County, OK",3146,446,2700,3407,310,2948,-2254,-2638,0
963,40095,"Marshall County, OK",5140,1396,3744,5492,1096,4206,-2348,-3110,0
964,40097,"Mayes County, OK",14456,4822,9634,15717,3423,11555,-4812,-8132,0
965,40087,"McClain County, OK",14299,3191,11108,16858,2894,13169,-7917,-10275,0
966,40089,"McCurtain County, OK",10073,2440,7633,10726,1802,8656,-5193,-6854,0
967,40091,"McIntosh County, OK",7265,2767,4498,7963,2123,5505,-1731,-3382,0
968,40099,"Murray County, OK",5146,1540,3606,5528,1087,4175,-2066,-3088,0
969,40101,"Muskogee County, OK",23335,9943,13392,24216,7977,15043,-3449,-7066,0
970,40103,"Noble County, OK",4626,1142,3484,4878,901,3715,-2342,-2814,0
971,40105,"Nowata County, OK",4076,1244,2832,4237,742,3321,-1588,-2579,0
972,40107,"Okfuskee County, OK",3579,1251,2328,3943,943,2800,-1077,-1857,0
973,40109,"Oklahoma County, OK",256337,106812,149525,273942,112813,141569,-42713,-28756,0
974,40111,"Okmulgee County, OK",13128,5416,7712,13949,4385,8944,-2296,-4559,0
975,40113,"Osage County, OK",17913,6695,11218,18966,5597,12577,-4523,-6980,0
976,40115,"Ottawa County, OK",9973,3508,6465,10690,2584,7631,-2957,-5047,0
977,40117,"Pawnee County, OK",6041,1813,4228,6364,1344,4729,-2415,-3385,0
978,40119,"Payne County, OK",25660,9193,16467,27760,8788,16651,-7274,-7863,0
979,40121,"Pittsburg County, OK",15598,4813,10785,17271,3711,12753,-5972,-9042,0
980,40123,"Pontotoc County, OK",12855,3934,8921,14831,3637,10431,-4987,-6794,0
981,40125,"Pottawatomie County, OK",23422,7182,16240,25452,6015,17848,-9058,-11833,0
982,40127,"Pushmataha County, OK",4130,1043,3087,4483,748,3581,-2044,-2833,0
983,40129,"Roger Mills County, OK",1674,272,1402,1759,151,1547,-1130,-1396,0
984,40131,"Rogers County, OK",36677,9146,27531,40862,7902,30913,-18385,-23011,0
985,40133,"Seminole County, OK",7449,2597,4852,8037,2071,5613,-2255,-3542,0
986,40135,"Sequoyah County, OK",13766,4193,9573,14437,3061,10888,-5380,-7827,0
987,40137,"Stephens County, OK",16846,3939,12907,17904,3086,14182,-8968,-11096,0
988,40139,"Texas County, OK",5762,854,4908,5780,858,4621,-4054,-3763,0
989,40141,"Tillman County, OK",2719,906,1813,2706,657,1944,-907,-1287,0
990,40143,"Tulsa County, OK",227541,82633,144908,247054,87847,144258,-62275,-56411,0
991,40145,"Wagoner County, OK",28621,7773,20848,31300,6723,23005,-13075,-16282,0
992,40147,"Washington County, OK",21199,5532,15667,22224,5048,15825,-10135,-10777,0
993,40149,"Washita County, OK",4303,821,3482,4631,588,3854,-2661,-3266,0
994,40151,"Woods County, OK",3395,670,2725,3668,522,2947,-2055,-2425,0
995,40153,"Woodward County, OK",7065,1129,5936,7595,873,6347,-4807,-5474,0
996,1001,"Autauga County, AL",23909,6354,17366,24973,5936,18172,-11012,-12236,0
997,1003,"Baldwin County, AL",84988,18329,65772,95215,18458,72883,-47443,-54425,0
998,1005,"Barbour County, AL",11459,5873,5539,10469,4871,5454,334,-583,1
999,1007,"Bibb County, AL",8391,2200,6131,8819,1874,6738,-3931,-4864,0
1000,1009,"Blount County, AL",23980,2961,20741,25588,2156,22859,-17780,-20703,0
1001,1011,"Bullock County, AL",5318,4058,1250,4710,3530,1140,2808,2390,0
1002,1013,"Butler County, AL",9483,4367,5081,8732,3726,4901,-714,-1175,0
1003,1015,"Calhoun County, AL",46240,15500,30272,47864,13242,32865,-14772,-19623,0
1004,1017,"Chambers County, AL",14562,6853,7596,13900,5784,7843,-743,-2059,0
1005,1019,"Cherokee County, AL",9761,2126,7494,10733,1547,8953,-5368,-7406,0
1006,1021,"Chilton County, AL",17434,3391,13910,18369,2911,15081,-10519,-12170,0
1007,1023,"Choctaw County, AL",7965,3785,4150,7292,3109,4106,-365,-997,0
1008,1025,"Clarke County, AL",13827,6317,7463,13031,5749,7140,-1146,-1391,0
1009,1027,"Clay County, AL",6640,1770,4802,6624,1237,5245,-3032,-4008,0
1010,1029,"Cleburne County, AL",6302,971,5269,6593,684,5764,-4298,-5080,0
1011,1031,"Coffee County, AL",19715,4899,14638,20767,4221,15875,-9739,-11654,0
1012,1033,"Colbert County, AL",23374,9160,13931,24915,7312,16746,-4771,-9434,0
1013,1035,"Conecuh County, AL",7013,3551,3434,6585,3080,3420,117,-340,1
1014,1037,"Coosa County, AL",5243,2188,3028,5252,1782,3381,-840,-1599,0
1015,1039,"Covington County, AL",15415,3155,12148,15940,2387,13267,-8993,-10880,0
1016,1041,"Crenshaw County, AL",6411,2048,4326,6267,1664,4513,-2278,-2849,0
1017,1043,"Cullman County, AL",33178,4855,27930,37873,3798,32989,-23075,-29191,0
1018,1045,"Dale County, AL",18551,5283,13105,18749,4413,13808,-7822,-9395,0
1019,1047,"Dallas County, AL",20936,14599,6284,18792,12836,5789,8315,7047,0
1020,1049,"DeKalb County, AL",23842,5235,18316,25826,3622,21405,-13081,-17783,0
1021,1051,"Elmore County, AL",35440,8940,26223,37260,8443,27634,-17283,-19191,0
1022,1053,"Escambia County, AL",14832,5476,9263,14845,4605,9935,-3787,-5330,0
1023,1055,"Etowah County, AL",42490,12792,29102,44164,10442,32353,-16310,-21911,0
1024,1057,"Fayette County, AL",7912,1803,6034,8249,1362,6712,-4231,-5350,0
1025,1059,"Franklin County, AL",10859,3171,7567,12040,2197,9466,-4396,-7269,0
1026,1061,"Geneva County, AL",11318,2039,9173,11758,1525,9994,-7134,-8469,0
1027,1063,"Greene County, AL",5328,4514,799,4880,4013,838,3715,3175,0
1028,1065,"Hale County, AL",8628,5401,3205,8040,4775,3173,2196,1602,0
1029,1067,"Henry County, AL",8700,3046,5605,8072,2292,5632,-2559,-3340,0
1030,1069,"Houston County, AL",41843,12348,29214,42639,10664,30728,-16866,-20064,0
1031,1071,"Jackson County, AL",20555,5817,14422,20984,3673,16672,-8605,-12999,0
1032,1073,"Jefferson County, AL",303424,159658,141413,304191,156873,134768,18245,22105,0
1033,1075,"Lamar County, AL",7159,1643,5453,6966,1036,5823,-3810,-4787,0
1034,1077,"Lauderdale County, AL",36908,12504,23902,39525,9952,27899,-11398,-17947,0
1035,1079,"Lawrence County, AL",14079,5055,8855,14829,3627,10833,-3800,-7206,0
1036,1081,"Lee County, AL",54115,21274,32062,59191,21230,34617,-10788,-13387,0
1037,1083,"Limestone County, AL",35406,9809,25263,40294,9468,29067,-15454,-19599,0
1038,1085,"Lowndes County, AL",7519,5747,1754,6684,4883,1751,3993,3132,0
1039,1087,"Macon County, AL",10385,9045,1322,9140,7566,1431,7723,6135,0
1040,1089,"Madison County, AL",154632,61802,90679,163389,62822,89520,-28877,-26698,0
1041,1091,"Marengo County, AL",11509,6154,5321,10994,5615,5233,833,382,0
1042,1093,"Marion County, AL",12104,2249,9696,12984,1432,11274,-7447,-9842,0
1043,1095,"Marshall County, AL",32455,6271,25785,35316,4917,29233,-19514,-24316,0
1044,1097,"Mobile County, AL",174189,78417,94566,172737,72186,95116,-16149,-22930,0
1045,1099,"Monroe County, AL",10680,4897,5730,10271,4332,5795,-833,-1463,0
1046,1101,"Montgomery County, AL",101781,62993,38283,95878,58916,34003,24710,24913,0
1047,1103,"Morgan County, AL",49198,13401,35309,50644,11254,37486,-21908,-26232,0
1048,1105,"Perry County, AL",6065,4536,1504,5278,3824,1407,3032,2417,0
1049,1107,"Pickens County, AL",9599,4448,5119,9542,3972,5456,-671,-1484,0
1050,1109,"Pike County, AL",14057,6009,7939,13168,5056,7693,-1930,-2637,0
1051,1111,"Randolph County, AL",10391,3076,7219,10187,2291,7705,-4143,-5414,0
1052,1113,"Russell County, AL",18871,10495,8276,19256,9579,9210,2219,369,0
1053,1117,"Shelby County, AL",92204,19944,71243,101254,22977,73020,-51299,-50043,0
1054,1115,"St. Clair County, AL",35105,5790,29001,38400,5589,31651,-23211,-26062,0
1055,1119,"Sumter County, AL",7025,5420,1585,6411,4746,1581,3835,3165,0
1056,1121,"Talladega County, AL",33317,13878,19217,33407,12121,20614,-5339,-8493,0
1057,1123,"Tallapoosa County, AL",18668,6252,12303,19486,5519,13594,-6051,-8075,0
1058,1125,"Tuscaloosa County, AL",78495,32003,45703,82700,31762,47723,-13700,-15961,0
1059,1127,"Walker County, AL",28497,6551,21633,29472,4497,24266,-15082,-19769,0
1060,1129,"Washington County, AL",8761,2971,5749,8533,2374,6042,-2778,-3668,0
1061,1131,"Wilcox County, AL",6547,4867,1676,6123,4339,1742,3191,2597,0
1062,1133,"Winston County, AL",9712,1286,8310,10313,872,9228,-7024,-8356,0
1063,20001,"Allen County, KS",5221,1842,3261,5454,1433,3651,-1419,-2218,0
1064,20003,"Anderson County, KS",3274,937,2246,3350,672,2435,-1309,-1763,0
1065,20005,"Atchison County, KS",6499,2486,3836,6575,1989,4049,-1350,-2060,0
1066,20007,"Barber County, KS",2282,473,1753,2252,286,1850,-1280,-1564,0
1067,20009,"Barton County, KS",12010,2693,9132,10337,1839,7888,-6439,-6049,0
1068,20011,"Bourbon County, KS",6118,1951,4022,6093,1336,4424,-2071,-3088,0
1069,20013,"Brown County, KS",3865,1039,2738,4036,863,2906,-1699,-2043,0
1070,20015,"Butler County, KS",25452,7124,17764,27657,6573,19073,-10640,-12500,0
1071,20017,"Chase County, KS",1233,343,857,1369,316,969,-514,-653,0
1072,20019,"Chautauqua County, KS",1502,259,1201,1481,197,1236,-942,-1039,0
1073,20021,"Cherokee County, KS",8396,2868,5345,8620,2005,6182,-2477,-4177,0
1074,20023,"Cheyenne County, KS",1422,231,1157,1407,181,1173,-926,-992,0
1075,20025,"Clark County, KS",1000,171,791,1005,120,825,-620,-705,0
1076,20027,"Clay County, KS",3584,811,2715,3820,677,2891,-1904,-2214,0
1077,20029,"Cloud County, KS",3957,951,2886,3930,761,2919,-1935,-2158,0
1078,20031,"Coffey County, KS",3839,884,2860,4068,727,3050,-1976,-2323,0
1079,20033,"Comanche County, KS",915,141,756,867,102,715,-615,-613,0
1080,20035,"Cowley County, KS",12444,4219,7932,12621,3551,8270,-3713,-4719,0
1081,20037,"Crawford County, KS",14385,6545,7480,14891,5199,8624,-935,-3425,0
1082,20039,"Decatur County, KS",1533,266,1219,1452,178,1210,-953,-1032,0
1083,20041,"Dickinson County, KS",7854,1962,5709,8210,1609,6029,-3747,-4420,0
1084,20043,"Doniphan County, KS",3369,885,2397,3378,587,2606,-1512,-2019,0
1085,20045,"Douglas County, KS",46283,28012,17028,50087,31195,14688,10984,16507,0
1086,20047,"Edwards County, KS",1365,291,1048,1319,212,1037,-757,-825,0
1087,20049,"Elk County, KS",1356,277,1040,1259,160,1048,-763,-888,0
1088,20051,"Ellis County, KS",12779,3464,9057,11947,2742,8466,-5593,-5724,0
1089,20053,"Ellsworth County, KS",2677,696,1905,2679,521,1969,-1209,-1448,0
1090,20055,"Finney County, KS",7593,2307,5108,10159,3195,6350,-2801,-3155,0
1091,20057,"Ford County, KS",8082,2468,5459,7718,2149,5114,-2991,-2965,0
1092,20059,"Franklin County, KS",10806,3611,6893,10965,2892,7185,-3282,-4293,0
1093,20061,"Geary County, KS",7526,3158,4242,7504,2722,4274,-1084,-1552,0
1094,20063,"Gove County, KS",1368,174,1155,1343,149,1140,-981,-991,0
1095,20065,"Graham County, KS",1319,248,1044,1284,188,1025,-796,-837,0
1096,20067,"Grant County, KS",2215,437,1742,2389,441,1804,-1305,-1363,0
1097,20069,"Gray County, KS",1901,304,1568,2066,263,1698,-1264,-1435,0
1098,20071,"Greeley County, KS",665,112,539,650,83,534,-427,-451,0
1099,20073,"Greenwood County, KS",2706,653,1986,2840,485,2160,-1333,-1675,0
1100,20075,"Hamilton County, KS",857,159,678,876,121,705,-519,-584,0
1101,20077,"Harper County, KS",2335,536,1723,2578,393,1996,-1187,-1603,0
1102,20079,"Harvey County, KS",13805,5162,8352,14916,5068,8668,-3190,-3600,0
1103,20081,"Haskell County, KS",1355,202,1131,1354,245,1040,-929,-795,0
1104,20083,"Hodgeman County, KS",1050,178,857,1017,124,855,-679,-731,0
1105,20085,"Jackson County, KS",5474,1870,3476,5818,1512,3939,-1606,-2427,0
1106,20087,"Jefferson County, KS",7725,2883,4647,8337,2518,5213,-1764,-2695,0
1107,20089,"Jewell County, KS",1477,225,1220,1494,180,1223,-995,-1043,0
1108,20091,"Johnson County, KS",268145,107651,155442,294208,129852,137490,-47791,-7638,0
1109,20093,"Kearny County, KS",1341,261,1060,1316,174,1075,-799,-901,0
1110,20095,"Kingman County, KS",3199,731,2371,3334,599,2530,-1640,-1931,0
1111,20097,"Kiowa County, KS",1133,160,970,1079,114,900,-810,-786,0
1112,20099,"Labette County, KS",7907,3074,4668,8107,2291,5335,-1594,-3044,0
1113,20101,"Lane County, KS",917,170,732,871,106,718,-562,-612,0
1114,20103,"Leavenworth County, KS",28532,11072,16825,30639,10209,17638,-5753,-7429,0
1115,20105,"Lincoln County, KS",1459,284,1148,1464,215,1179,-864,-964,0
1116,20107,"Linn County, KS",4294,1108,3079,4454,736,3484,-1971,-2748,0
1117,20109,"Logan County, KS",1302,194,1084,1357,149,1132,-890,-983,0
1118,20111,"Lyon County, KS",11614,4972,6358,12472,4649,6552,-1386,-1903,0
1119,20115,"Marion County, KS",5368,1371,3865,5624,1204,4003,-2494,-2799,0
1120,20117,"Marshall County, KS",4679,1451,3123,4673,1072,3307,-1672,-2235,0
1121,20113,"McPherson County, KS",12060,3384,8399,12742,3226,8549,-5015,-5323,0
1122,20119,"Meade County, KS",1648,254,1394,1732,210,1415,-1140,-1205,0
1123,20121,"Miami County, KS",14642,4635,9726,15022,3991,10003,-5091,-6012,0
1124,20123,"Mitchell County, KS",2923,576,2293,2942,477,2308,-1717,-1831,0
1125,20125,"Montgomery County, KS",12093,3406,8417,12004,2637,8679,-5011,-6042,0
1126,20127,"Morris County, KS",2526,705,1750,2624,601,1820,-1045,-1219,0
1127,20129,"Morton County, KS",1247,180,1050,1192,147,995,-870,-848,0
1128,20131,"Nemaha County, KS",4959,988,3878,5122,725,4124,-2890,-3399,0
1129,20133,"Neosho County, KS",6359,2012,4193,6314,1501,4431,-2181,-2930,0
1130,20135,"Ness County, KS",1417,211,1190,1454,162,1228,-979,-1066,0
1131,20137,"Norton County, KS",2296,393,1855,2234,281,1840,-1462,-1559,0
1132,20139,"Osage County, KS",6771,2228,4336,7046,1753,4826,-2108,-3073,0
1133,20141,"Osborne County, KS",1802,320,1448,1788,233,1460,-1128,-1227,0
1134,20143,"Ottawa County, KS",2888,548,2260,2903,424,2283,-1712,-1859,0
1135,20145,"Pawnee County, KS",2565,704,1808,2661,579,1904,-1104,-1325,0
1136,20147,"Phillips County, KS",2537,376,2116,2664,300,2233,-1740,-1933,0
1137,20149,"Pottawatomie County, KS",9303,2291,6692,10693,2225,7612,-4401,-5387,0
1138,20151,"Pratt County, KS",3752,974,2730,3842,771,2838,-1756,-2067,0
1139,20153,"Rawlins County, KS",1420,184,1207,1472,163,1220,-1023,-1057,0
1140,20155,"Reno County, KS",23869,7888,15398,24536,6837,15513,-7510,-8676,0
1141,20157,"Republic County, KS",2640,470,2098,2529,375,2024,-1628,-1649,0
1142,20159,"Rice County, KS",3622,899,2631,3804,695,2837,-1732,-2142,0
1143,20161,"Riley County, KS",20266,8587,11157,21974,9341,10107,-2570,-766,0
1144,20163,"Rooks County, KS",2625,398,2159,2419,275,2031,-1761,-1756,0
1145,20165,"Rush County, KS",1549,361,1151,1503,233,1197,-790,-964,0
1146,20167,"Russell County, KS",3140,584,2505,3193,461,2574,-1921,-2113,0
1147,20169,"Saline County, KS",21102,6910,13697,22064,6317,13828,-6787,-7511,0
1148,20171,"Scott County, KS",2019,271,1702,2202,236,1865,-1431,-1629,0
1149,20173,"Sedgwick County, KS",177852,69373,104411,191798,69627,104353,-35038,-34726,0
1150,20175,"Seward County, KS",4955,1393,3495,5038,1628,3159,-2102,-1531,0
1151,20177,"Shawnee County, KS",74844,35959,37226,76766,33926,35934,-1267,-2008,0
1152,20179,"Sheridan County, KS",1320,165,1136,1374,127,1197,-971,-1070,0
1153,20181,"Sherman County, KS",2606,575,1967,2612,347,2089,-1392,-1742,0
1154,20183,"Smith County, KS",1983,345,1598,2042,297,1661,-1253,-1364,0
1155,20185,"Stafford County, KS",1833,403,1382,1896,304,1490,-979,-1186,0
1156,20187,"Stanton County, KS",713,135,571,637,115,492,-436,-377,0
1157,20189,"Stevens County, KS",1998,241,1724,1891,220,1599,-1483,-1379,0
1158,20191,"Sumner County, KS",8989,2617,6162,9722,2076,6984,-3545,-4908,0
1159,20193,"Thomas County, KS",3388,576,2729,3576,473,2908,-2153,-2435,0
1160,20195,"Trego County, KS",1544,289,1230,1482,198,1227,-941,-1029,0
1161,20197,"Wabaunsee County, KS",3229,908,2230,3380,776,2372,-1322,-1596,0
1162,20199,"Wallace County, KS",781,68,702,798,46,721,-634,-675,0
1163,20201,"Washington County, KS",2863,515,2300,2765,387,2194,-1785,-1807,0
1164,20203,"Wichita County, KS",987,157,821,956,140,769,-664,-629,0
1165,20205,"Wilson County, KS",3699,813,2812,3591,594,2788,-1999,-2194,0
1166,20207,"Woodson County, KS",1435,377,1030,1443,273,1082,-653,-809,0
1167,20209,"Wyandotte County, KS",49422,33265,15273,49243,30146,15806,17992,14340,0
1168,23001,"Androscoggin County, ME",52539,28912,22210,55601,23009,28227,6702,-5218,1
1169,23003,"Aroostook County, ME",33866,17844,15229,35097,13386,19419,2615,-6033,1
1170,23005,"Cumberland County, ME",166895,100977,57008,171818,102981,57709,43969,45272,0
1171,23007,"Franklin County, ME",16112,9292,6305,16488,7016,7918,2987,-902,1
1172,23009,"Hancock County, ME",30738,17533,12398,32130,16117,13705,5135,2412,0
1173,23011,"Kennebec County, ME",63225,35022,26506,66208,29302,31675,8516,-2373,1
1174,23013,"Knox County, ME",22002,13227,8262,23147,12443,9148,4965,3295,0
1175,23015,"Lincoln County, ME",20668,11298,8884,21503,10241,9727,2414,514,0
1176,23017,"Oxford County, ME",28734,16052,11766,31201,12172,16210,4286,-4038,1
1177,23019,"Penobscot County, ME",77171,38816,36592,80540,32838,41622,2224,-8784,1
1178,23021,"Piscataquis County, ME",8990,4168,4577,9182,3098,5406,-409,-2308,0
1179,23023,"Sagadahoc County, ME",20734,11821,8429,21616,10664,9304,3392,1360,0
1180,23025,"Somerset County, ME",24705,12211,11798,26064,9092,15001,413,-5909,1
1181,23027,"Waldo County, ME",20976,11292,9055,22707,10440,10378,2237,62,0
1182,23029,"Washington County, ME",15756,7797,7539,16365,6075,9093,258,-3018,1
1183,23031,"York County, ME",107627,61492,43879,114274,55844,50403,17613,5441,0
1184,36001,"Albany County, NY",125531,80891,42029,139830,83077,47810,38862,35267,0
1185,36003,"Allegany County, NY",15601,5658,9609,18692,4882,12525,-3951,-7643,0
1186,36005,"Bronx County, NY",316047,288378,26304,399522,353646,37797,262074,315849,0
1187,36047,"Kings County, NY",618035,503291,108630,805605,640553,141044,394661,499509,0
1188,36007,"Broome County, NY",75244,38315,34878,86072,39212,40943,3437,-1731,1
1189,36009,"Cattaraugus County, NY",27608,11695,15406,31161,9497,19692,-3711,-10195,0
1190,36011,"Cayuga County, NY",26073,14162,11355,33172,13522,17384,2807,-3862,1
1191,36013,"Chautauqua County, NY",48434,21815,25795,54234,19091,31594,-3980,-12503,0
1192,36015,"Chemung County, NY",31981,15285,16207,36119,13757,20097,-922,-6340,0
1193,36017,"Chenango County, NY",17655,8340,8933,20160,6775,11921,-593,-5146,0
1194,36019,"Clinton County, NY",27622,17123,10054,32105,15059,14449,7069,610,0
1195,36021,"Columbia County, NY",26008,14244,11194,30902,15284,13756,3050,1528,0
1196,36023,"Cortland County, NY",17698,9445,7886,20244,8771,9900,1559,-1129,1
1197,36025,"Delaware County, NY",16916,7469,9085,19792,6627,11942,-1616,-5315,0
1198,36027,"Dutchess County, NY",114142,59885,52320,130934,62261,61797,7565,464,0
1199,36029,"Erie County, NY",386665,220184,159678,423625,215456,188303,60506,27153,0
1200,36031,"Essex County, NY",15577,8835,6495,17218,7762,7958,2340,-196,1
1201,36033,"Franklin County, NY",14537,9065,5248,16952,7297,8221,3817,-924,1
1202,36035,"Fulton County, NY",18040,7916,9811,21214,6496,13462,-1895,-6966,0
1203,36037,"Genesee County, NY",23079,8886,13701,26432,7650,16915,-4815,-9265,0
1204,36039,"Greene County, NY",18263,7911,9935,22050,7405,13073,-2024,-5668,0
1205,36041,"Hamilton County, NY",2655,955,1652,3225,949,2064,-697,-1115,0
1206,36043,"Herkimer County, NY",23290,10433,12389,26255,8083,16699,-1956,-8616,0
1207,36045,"Jefferson County, NY",32051,15345,16279,38236,13809,21763,-934,-7954,0
1208,36049,"Lewis County, NY",9481,4263,5083,11325,3146,7400,-820,-4254,0
1209,36051,"Livingston County, NY",24606,10889,13210,30031,10697,17290,-2321,-6593,0
1210,36053,"Madison County, NY",25865,12698,12611,30064,11667,15936,87,-4269,1
1211,36061,"New York County, NY",496293,417861,72300,668939,579013,64929,345561,514084,0
1212,36055,"Monroe County, NY",308925,178491,124769,347790,188592,136582,53722,52010,0
1213,36057,"Montgomery County, NY",16784,7881,8622,19054,6595,11301,-741,-4706,0
1214,36059,"Nassau County, NY",460824,243649,212882,647122,332154,292025,30767,40129,0
1215,36063,"Niagara County, NY",82720,40862,40397,92402,35559,51961,465,-16402,1
1216,36065,"Oneida County, NY",80429,37388,41639,91009,33743,51437,-4251,-17694,0
1217,36067,"Onondaga County, NY",188787,112664,72807,208440,112337,83649,39857,28688,0
1218,36069,"Ontario County, NY",44144,21285,21998,52258,22233,26029,-713,-3796,0
1219,36071,"Orange County, NY",130494,67709,60984,152021,68278,76645,6725,-8367,1
1220,36073,"Orleans County, NY",13756,5411,8076,16380,4470,10936,-2665,-6466,0
1221,36075,"Oswego County, NY",41133,21733,18503,48180,17095,27688,3230,-10593,1
1222,36077,"Otsego County, NY",21938,10975,10527,25668,10451,13308,448,-2857,1
1223,36079,"Putnam County, NY",40883,17851,22436,48563,19366,27024,-4585,-7658,0
1224,36081,"Queens County, NY",507722,399970,103193,686393,517220,149341,296777,367879,0
1225,36083,"Rensselaer County, NY",63332,34713,27240,71562,32717,33726,7473,-1009,1
1226,36087,"Rockland County, NY",114500,60446,52936,135087,69342,60911,7510,8431,0
1227,36089,"St. Lawrence County, NY",34023,19574,13914,39158,16488,19942,5660,-3454,1
1228,36091,"Saratoga County, NY",97502,48876,46829,114094,50913,54575,2047,-3662,1
1229,36093,"Schenectady County, NY",59614,33777,24608,67280,33747,28953,9169,4794,0
1230,36095,"Schoharie County, NY",11943,4862,6849,14050,4240,8831,-1987,-4591,0
1231,36097,"Schuyler County, NY",7464,3354,3942,8772,3091,5050,-588,-1959,0
1232,36099,"Seneca County, NY",12148,6526,5405,13980,5697,7236,1121,-1539,1
1233,36085,"Richmond County, NY",135283,67524,66420,180960,74143,101437,1104,-27294,1
1234,36101,"Steuben County, NY",35659,14586,20425,42002,12526,26831,-5839,-14305,0
1235,36103,"Suffolk County, NY",540653,274830,259348,681254,303951,350570,15482,-46619,1
1236,36105,"Sullivan County, NY",25322,13781,11148,29955,12568,15931,2633,-3363,1
1237,36107,"Tioga County, NY",19977,8263,11278,22299,7526,13260,-3015,-5734,0
1238,36109,"Tompkins County, NY",35825,24447,10202,42678,28890,10371,14245,18519,0
1239,36111,"Ulster County, NY",72193,43164,27340,85290,44597,35239,15824,9358,0
1240,36113,"Warren County, NY",26220,13112,12571,31408,13091,15751,541,-2660,1
1241,36115,"Washington County, NY",21263,10596,10254,24528,9098,13610,342,-4512,1
1242,36117,"Wayne County, NY",34127,15136,18315,39687,13473,23380,-3179,-9907,0
1243,36119,"Westchester County, NY",284731,171908,108707,420655,272926,131238,63201,141688,0
1244,36121,"Wyoming County, NY",15230,5224,9726,17298,3904,12442,-4502,-8538,0
1245,36123,"Yates County, NY",8437,4021,4270,10066,3659,5660,-249,-2001,0
1246,9001,"Fairfield County, CT",390611,214757,172238,421209,243852,160077,42519,83775,0
1247,9003,"Hartford County, CT",392485,244314,143648,406864,240403,148173,100666,92230,0
1248,9005,"Litchfield County, CT",92404,43823,47207,97442,39775,53051,-3384,-13276,0
1249,9007,"Middlesex County, CT",83447,47851,34533,88624,45357,38867,13318,6490,0
1250,9009,"New Haven County, CT",371783,230040,137942,379006,205609,159048,92098,46561,0
1251,9011,"New London County, CT",114043,66510,45715,123528,62278,54058,20795,8220,0
1252,9013,"Tolland County, CT",70780,39283,30391,77424,38506,34194,8892,4312,0
1253,9015,"Windham County, CT",46634,25953,19758,50823,21792,25747,6195,-3955,1
1254,41001,"Baker County, OR",8351,2364,5692,8779,1797,6218,-3328,-4421,0
1255,41003,"Benton County, OR",44262,27662,14922,48753,29193,13445,12740,15748,0
1256,41005,"Clackamas County, OR",185812,94159,87647,214039,102095,88392,6512,13703,0
1257,41007,"Clatsop County, OR",17206,9616,7101,19664,9252,8138,2515,1114,0
1258,41009,"Columbia County, OR",23298,11843,10645,26618,10167,13217,1198,-3050,1
1259,41011,"Coos County, OR",27926,12628,14398,31313,10448,17865,-1770,-7417,0
1260,41013,"Crook County, OR",10109,3081,6769,12172,2637,8511,-3688,-5874,0
1261,41015,"Curry County, OR",11529,4611,6577,12611,4300,7212,-1966,-2912,0
1262,41017,"Deschutes County, OR",77441,34985,40670,98557,42444,45692,-5685,-3248,0
1263,41019,"Douglas County, OR",49062,17032,30588,53521,14096,34582,-13556,-20486,0
1264,41021,"Gilliam County, OR",1044,371,637,1019,239,671,-266,-432,0
1265,41023,"Grant County, OR",3778,834,2848,4340,739,3210,-2014,-2471,0
1266,41025,"Harney County, OR",3535,829,2599,3974,683,2912,-1770,-2229,0
1267,41027,"Hood River County, OR",9662,5977,3400,10910,6510,3272,2577,3238,0
1268,41029,"Jackson County, OR",91955,42341,46974,109327,44447,53870,-4633,-9423,0
1269,41031,"Jefferson County, OR",7978,3238,4576,9459,2980,5483,-1338,-2503,0
1270,41033,"Josephine County, OR",39679,14929,23636,44560,13453,26923,-8707,-13470,0
1271,41035,"Klamath County, OR",27530,8140,18654,30507,7210,20435,-10514,-13225,0
1272,41037,"Lake County, OR",3676,769,2801,3930,639,3022,-2032,-2383,0
1273,41039,"Lane County, OR",166176,99891,60979,191950,102753,67141,38912,35612,0
1274,41041,"Lincoln County, OR",22612,13277,8623,25256,12501,10039,4654,2462,0
1275,41043,"Linn County, OR",49987,19893,28482,58719,17995,33488,-8589,-15493,0
1276,41045,"Malheur County, OR",9711,2701,6751,10435,2246,7194,-4050,-4948,0
1277,41047,"Marion County, OR",115519,54337,58435,136840,57788,63377,-4098,-5589,0
1278,41049,"Morrow County, OR",3838,1189,2524,4167,1017,2721,-1335,-1704,0
1279,41051,"Multnomah County, OR",350952,265938,73306,399103,292561,67954,192632,224607,0
1280,41053,"Polk County, OR",33996,15761,17377,40295,16420,18940,-1616,-2520,0
1281,41055,"Sherman County, OR",1019,317,677,1017,202,732,-360,-530,0
1282,41057,"Tillamook County, OR",12346,6249,5670,13803,5768,6538,579,-770,1
1283,41059,"Umatilla County, OR",24623,8499,15425,27597,7673,17059,-6926,-9386,0
1284,41061,"Union County, OR",11905,3943,7608,12968,3249,8431,-3665,-5182,0
1285,41063,"Wallowa County, OR",4152,1252,2796,4366,1116,2848,-1544,-1732,0
1286,41065,"Wasco County, OR",10550,5066,5152,11964,4781,5833,-86,-1052,0
1287,41067,"Washington County, OR",216473,124431,86551,269232,153251,83197,37880,70054,0
1288,41069,"Wheeler County, OR",841,262,542,818,155,591,-280,-436,0
1289,41071,"Yamhill County, OR",41750,18906,21711,48753,19301,23250,-2805,-3949,0
1290,53001,"Adams County, WA",4707,1516,3111,4782,1299,3083,-1595,-1784,0
1291,53003,"Asotin County, WA",9883,3993,5647,9974,3134,5741,-1654,-2607,0
1292,53005,"Benton County, WA",78874,27846,49105,83592,26360,47194,-21259,-20834,0
1293,53007,"Chelan County, WA",31899,12938,18237,34433,13032,18114,-5299,-5082,0
1294,53009,"Clallam County, WA",37687,18383,18273,40533,17677,18794,110,-1117,1
1295,53011,"Clark County, WA",183728,89817,89696,208485,92757,92441,121,316,0
1296,53013,"Columbia County, WA",2222,634,1545,2229,526,1497,-911,-971,0
1297,53015,"Cowlitz County, WA",44173,22507,20538,47142,17908,24185,1969,-6277,1
1298,53017,"Douglas County, WA",14678,5047,9287,15901,4918,9603,-4240,-4685,0
1299,53019,"Ferry County, WA",3391,1276,1966,3644,1098,2202,-690,-1104,0
1300,53021,"Franklin County, WA",19675,7332,11912,24614,8886,13206,-4580,-4320,0
1301,53023,"Garfield County, WA",1275,335,912,1266,279,851,-577,-572,0
1302,53025,"Grant County, WA",27250,8834,17677,29258,7810,18518,-8843,-10708,0
1303,53027,"Grays Harbor County, WA",28224,15692,11743,29301,12020,14067,3949,-2047,1
1304,53029,"Island County, WA",41319,21080,19251,44273,20960,18465,1829,2495,0
1305,53031,"Jefferson County, WA",18717,11985,6113,20879,12656,6037,5872,6619,0
1306,53033,"King County, WA",879643,605247,254293,1028450,718322,216339,350954,501983,0
1307,53035,"Kitsap County, WA",112496,61187,48454,128770,63156,49018,12733,14138,0
1308,53037,"Kittitas County, WA",15152,6462,8372,19615,7489,10100,-1910,-2611,0
1309,53039,"Klickitat County, WA",9861,4373,5138,11074,4194,5789,-765,-1595,0
1310,53041,"Lewis County, WA",26348,9772,15954,35199,9654,21992,-6182,-12338,0
1311,53043,"Lincoln County, WA",5804,1649,4024,5861,1244,4108,-2375,-2864,0
1312,53045,"Mason County, WA",27897,14568,12637,29003,11993,13677,1931,-1684,1
1313,53047,"Okanogan County, WA",12781,5259,7151,17556,6298,9610,-1892,-3312,0
1314,53049,"Pacific County, WA",10477,5684,4484,10972,4620,5360,1200,-740,1
1315,53051,"Pend Oreille County, WA",6649,2501,3942,7016,1934,4373,-1441,-2439,0
1316,53053,"Pierce County, WA",340027,184694,147422,360017,172538,146824,37272,25714,0
1317,53055,"San Juan County, WA",10345,6943,3061,11134,7172,2688,3882,4484,0
1318,53057,"Skagit County, WA",47989,24860,21930,58059,26690,24736,2930,1954,0
1319,53059,"Skamania County, WA",5326,2554,2624,5829,2232,2928,-70,-696,0
1320,53061,"Snohomish County, WA",305024,173695,123948,354734,185227,128255,49747,56972,0
1321,53063,"Spokane County, WA",212286,96781,109754,236050,93767,113435,-12973,-19668,0
1322,53065,"Stevens County, WA",18703,6521,11655,23395,5767,15161,-5134,-9394,0
1323,53067,"Thurston County, WA",111652,64879,43703,134191,68798,48624,21176,20174,0
1324,53069,"Wahkiakum County, WA",2285,1091,1115,2429,832,1344,-24,-512,0
1325,53071,"Walla Walla County, WA",18577,7083,11057,26228,9694,13651,-3974,-3957,0
1326,53073,"Whatcom County, WA",91158,49743,38764,113339,60340,40599,10979,19741,0
1327,53075,"Whitman County, WA",14851,6910,7460,18028,8146,7403,-550,743,0
1328,53077,"Yakima County, WA",68466,28761,38414,79741,31291,41735,-9653,-10444,0
1329,55001,"Adams County, WI",10263,5537,4643,10130,3745,5966,894,-2221,1
1330,55003,"Ashland County, WI",8342,5387,2816,8032,4226,3303,2571,923,0
1331,55005,"Barron County, WI",22583,10883,11413,22671,7889,13614,-530,-5725,0
1332,55007,"Bayfield County, WI",9759,6025,3597,9612,4953,4124,2428,829,0
1333,55009,"Brown County, WI",128514,62433,64738,129011,53382,67210,-2305,-13828,0
1334,55011,"Buffalo County, WI",7008,3569,3352,6981,2525,4048,217,-1523,1
1335,55013,"Burnett County, WI",8634,3981,4541,8738,2949,5410,-560,-2461,0
1336,55015,"Calumet County, WI",26336,11477,14519,26595,9642,15367,-3042,-5725,0
1337,55017,"Chippewa County, WI",30914,15211,15371,31568,11887,17916,-160,-6029,0
1338,55019,"Clark County, WI",13740,6173,7394,13673,4221,8652,-1221,-4431,0
1339,55021,"Columbia County, WI",30460,17158,13014,29698,13528,14163,4144,-635,1
1340,55023,"Crawford County, WI",7791,4622,3064,7728,3419,3836,1558,-417,1
1341,55025,"Dane County, WI",302845,215389,83459,309354,217697,71275,131930,146422,0
1342,55027,"Dodge County, WI",44379,18745,25190,43078,13968,26635,-6445,-12667,0
1343,55029,"Door County, WI",17607,9338,8109,17592,8014,8580,1229,-566,1
1344,55031,"Douglas County, WI",22862,14855,7698,22536,11357,9661,7157,1696,0
1345,55033,"Dunn County, WI",21899,11303,10210,22106,9034,11486,1093,-2452,1
1346,55035,"Eau Claire County, WI",54595,30618,23218,55025,27340,23331,7400,4009,0
1347,55037,"Florence County, WI",2615,952,1643,2656,665,1898,-691,-1233,0
1348,55039,"Fond du Lac County, WI",53272,22356,30329,51796,17387,31022,-7973,-13635,0
1349,55041,"Forest County, WI",4643,2421,2172,4545,1579,2787,249,-1208,1
1350,55043,"Grant County, WI",24160,13574,10255,24368,10051,12350,3319,-2299,1
1351,55045,"Green County, WI",19302,11196,7848,18985,9122,8693,3348,429,0
1352,55047,"Green Lake County, WI",9657,3790,5779,9416,2693,6216,-1989,-3523,0
1353,55049,"Iowa County, WI",12515,8099,4302,12275,6669,4809,3797,1860,0
1354,55051,"Iron County, WI",3620,1783,1788,3513,1275,2081,-5,-806,0
1355,55053,"Jackson County, WI",9290,5297,3900,9267,3818,4906,1397,-1088,1
1356,55055,"Jefferson County, WI",44136,20136,23489,43109,16569,23417,-3353,-6848,0
1357,55057,"Juneau County, WI",11781,6237,5400,11735,4073,7130,837,-3057,1
1358,55059,"Kenosha County, WI",80661,44838,34942,76304,35799,36037,9896,-238,1
1359,55061,"Kewaunee County, WI",11018,5151,5746,10767,3627,6618,-595,-2991,0
1360,55063,"La Crosse County, WI",63212,36632,25711,63674,32406,26378,10921,6028,0
1361,55065,"Lafayette County, WI",7928,4534,3313,7662,3288,3977,1221,-689,1
1362,55067,"Langlade County, WI",10482,4569,5810,10186,3250,6478,-1241,-3228,0
1363,55069,"Lincoln County, WI",15152,7543,7444,14712,5371,8401,99,-3030,1
1364,55071,"Manitowoc County, WI",42488,20382,21581,40786,14538,23244,-1199,-8706,0
1365,55073,"Marathon County, WI",69637,32330,36568,69518,26481,39014,-4238,-12533,0
1366,55075,"Marinette County, WI",20712,9868,10609,20343,6409,13122,-741,-6713,0
1367,55077,"Marquette County, WI",7944,4112,3758,7891,2808,4709,354,-1901,1
1368,55078,"Menominee County, WI",1376,1191,179,1308,1002,267,1012,735,0
1369,55079,"Milwaukee County, WI",490944,328090,158430,441053,288822,126069,169660,162753,0
1370,55081,"Monroe County, WI",19389,9505,9637,19699,7052,11356,-132,-4304,0
1371,55083,"Oconto County, WI",19727,8810,10691,20206,5940,13345,-1881,-7405,0
1372,55085,"Oneida County, WI",21577,10439,10905,21531,8109,12132,-466,-4023,0
1373,55087,"Outagamie County, WI",94237,45565,47294,93933,38068,49879,-1729,-11811,0
1374,55089,"Ozaukee County, WI",55565,19075,35991,54560,20170,30464,-16916,-10294,0
1375,55091,"Pepin County, WI",3696,1875,1793,3735,1344,2206,82,-862,1
1376,55093,"Pierce County, WI",20920,10213,10383,21376,8399,11272,-170,-2873,0
1377,55095,"Polk County, WI",22494,10054,12075,22745,7565,13810,-2021,-6245,0
1378,55097,"Portage County, WI",39186,22052,16599,38589,18529,17305,5453,1224,0
1379,55099,"Price County, WI",7870,3882,3879,7568,2667,4559,3,-1892,1
1380,55101,"Racine County, WI",102937,52887,49173,94302,42641,46681,3714,-4040,1
1381,55103,"Richland County, WI",8636,4964,3575,8069,3569,4013,1389,-444,1
1382,55105,"Rock County, WI",80462,49158,30492,76074,39339,31493,18666,7846,0
1383,55107,"Rusk County, WI",7171,3391,3673,7088,2171,4564,-282,-2393,0
1384,55111,"Sauk County, WI",31832,18718,12829,31357,14690,14799,5889,-109,1
1385,55113,"Sawyer County, WI",9003,4482,4436,9137,3503,5185,46,-1682,1
1386,55115,"Shawano County, WI",20222,8990,11017,19810,6068,12769,-2027,-6701,0
1387,55117,"Sheboygan County, WI",63272,28356,34282,59766,23000,32514,-5926,-9514,0
1388,55109,"St. Croix County, WI",46009,19874,25475,47508,17482,26222,-5601,-8740,0
1389,55119,"Taylor County, WI",9486,3761,5597,9471,2393,6579,-1836,-4186,0
1390,55121,"Trempealeau County, WI",13456,7601,5703,13687,5636,7366,1898,-1730,1
1391,55123,"Vernon County, WI",14215,8031,5935,14275,6371,7004,2096,-633,1
1392,55125,"Vilas County, WI",13782,5931,7735,13611,4770,8166,-1804,-3396,0
1393,55127,"Walworth County, WI",52115,22512,28962,51391,18710,28863,-6450,-10153,0
1394,55129,"Washburn County, WI",9242,4435,4692,9193,3282,5436,-257,-2154,0
1395,55131,"Washington County, WI",78558,23136,54709,76757,20852,51740,-31573,-30888,0
1396,55133,"Waukesha County, WI",241084,77617,161567,237593,79224,142543,-83950,-63319,0
1397,55135,"Waupaca County, WI",25801,11565,13989,26095,8451,16209,-2424,-7758,0
1398,55137,"Waushara County, WI",12017,5330,6558,12074,3791,7667,-1228,-3876,0
1399,55139,"Winnebago County, WI",88814,45410,42073,87135,37047,43445,3337,-6398,1
1400,55141,"Wood County, WI",38762,18546,19685,37818,14225,21498,-1139,-7273,0
1401,37001,"Alamance County, NC",66638,28341,37712,71157,29833,38815,-9371,-8982,0
1402,37003,"Alexander County, NC",17060,4591,12207,18271,3767,13893,-7616,-10126,0
1403,37005,"Alleghany County, NC",5025,1574,3378,5315,1306,3814,-1804,-2508,0
1404,37007,"Anson County, NC",11072,6894,4125,10545,5859,4506,2769,1353,0
1405,37009,"Ashe County, NC",12486,4100,8207,13424,3500,9412,-4107,-5912,0
1406,37011,"Avery County, NC",7657,1861,5708,8249,1689,6298,-3847,-4609,0
1407,37013,"Beaufort County, NC",23468,9399,13918,23938,8764,14543,-4519,-5779,0
1408,37015,"Bertie County, NC",9941,6537,3367,9347,5778,3456,3170,2322,0
1409,37017,"Bladen County, NC",16351,8277,7947,15897,7058,8550,330,-1492,1
1410,37019,"Brunswick County, NC",56985,21932,34587,68351,23282,42720,-12655,-19438,0
1411,37021,"Buncombe County, NC",126201,70066,54429,138947,75452,55716,15637,19736,0
1412,37023,"Burke County, NC",36116,13577,22109,38920,11251,26238,-8532,-14987,0
1413,37025,"Cabarrus County, NC",82445,32453,49125,93289,35521,53819,-16672,-18298,0
1414,37027,"Caldwell County, NC",34338,10795,23069,36320,8425,26621,-12274,-18196,0
1415,37029,"Camden County, NC",4520,1456,2995,5006,1274,3546,-1539,-2272,0
1416,37031,"Carteret County, NC",35124,10197,24598,37781,9939,26569,-14401,-16630,0
1417,37033,"Caswell County, NC",10736,5183,5471,11070,4792,6026,-288,-1234,0
1418,37035,"Catawba County, NC",69102,23954,44386,72351,21216,48324,-20432,-27108,0
1419,37037,"Chatham County, NC",35157,18252,16578,39849,21065,17105,1674,3960,0
1420,37039,"Cherokee County, NC",12695,3339,9201,14181,2860,10844,-5862,-7984,0
1421,37041,"Chowan County, NC",7424,3507,3872,7228,2992,4014,-365,-1022,0
1422,37043,"Clay County, NC",5592,1573,3952,6010,1367,4437,-2379,-3070,0
1423,37045,"Cleveland County, NC",42542,16734,25440,44673,14964,28479,-8706,-13515,0
1424,37047,"Columbus County, NC",24017,10973,12863,23732,9063,14272,-1890,-5209,0
1425,37049,"Craven County, NC",45585,18556,26654,47001,17630,27731,-8098,-10101,0
1426,37051,"Cumberland County, NC",126092,74991,50191,127506,71605,51265,24800,20340,0
1427,37053,"Currituck County, NC",11153,3521,7431,12669,2913,9163,-3910,-6250,0
1428,37055,"Dare County, NC",17614,7258,10102,19609,7222,11460,-2844,-4238,0
1429,37057,"Davidson County, NC",69994,20291,48935,74856,18109,54317,-28644,-36208,0
1430,37059,"Davie County, NC",20418,5652,14568,21756,5270,15602,-8916,-10332,0
1431,37061,"Duplin County, NC",20375,8923,11330,20856,8283,12217,-2407,-3934,0
1432,37063,"Durham County, NC",143828,109185,33326,156134,121250,28350,75859,92900,0
1433,37065,"Edgecombe County, NC",26826,18249,8494,24886,16224,8261,9755,7963,0
1434,37067,"Forsyth County, NC",172332,91606,79177,178312,94464,75975,12429,18489,0
1435,37069,"Franklin County, NC",28059,13317,14480,30368,12874,16368,-1163,-3494,0
1436,37071,"Gaston County, NC",89638,32903,55817,96431,31177,61798,-22914,-30621,0
1437,37073,"Gates County, NC",5310,2745,2532,5392,2385,2874,213,-489,1
1438,37075,"Graham County, NC",3910,1115,2743,4168,768,3283,-1628,-2515,0
1439,37077,"Granville County, NC",26068,13529,12332,27353,12909,13591,1197,-682,1
1440,37079,"Greene County, NC",8194,3761,4393,8095,3605,4374,-632,-769,0
1441,37081,"Guilford County, NC",251529,145483,103964,257405,149248,98062,41519,51186,0
1442,37083,"Halifax County, NC",25724,16931,8686,25167,15748,9031,8245,6717,0
1443,37085,"Harnett County, NC",42343,16858,25070,46065,16737,27614,-8212,-10877,0
1444,37087,"Haywood County, NC",27679,11742,15553,30727,10473,18929,-3811,-8456,0
1445,37089,"Henderson County, NC",51961,18519,32860,58176,19827,35809,-14341,-15982,0
1446,37091,"Hertford County, NC",10872,7815,3001,10186,6910,3099,4814,3811,0
1447,37093,"Hoke County, NC",16800,9915,6721,18230,9726,7760,3194,1966,0
1448,37095,"Hyde County, NC",2358,1157,1183,2304,965,1288,-26,-323,0
1449,37097,"Iredell County, NC",75762,25952,49071,82567,24734,54754,-23119,-30020,0
1450,37099,"Jackson County, NC",16556,8052,8224,18713,7713,9870,-172,-2157,0
1451,37101,"Johnston County, NC",76021,27052,48206,85909,28362,54372,-21154,-26010,0
1452,37103,"Jones County, NC",5192,2335,2825,5135,2065,2974,-490,-909,0
1453,37105,"Lee County, NC",23800,10577,13000,25084,10469,13712,-2423,-3243,0
1454,37107,"Lenoir County, NC",27247,13350,13763,26807,12634,13613,-413,-979,0
1455,37109,"Lincoln County, NC",36532,10980,25184,40023,9897,28806,-14204,-18909,0
1456,37113,"Macon County, NC",16750,5692,10817,17734,4876,12127,-5125,-7251,0
1457,37115,"Madison County, NC",10023,4466,5379,11269,3926,6783,-913,-2857,0
1458,37117,"Martin County, NC",12541,6514,5963,11964,5846,5897,551,-51,1
1459,37111,"McDowell County, NC",17953,6006,11732,19875,4667,14568,-5726,-9901,0
1460,37119,"Mecklenburg County, NC",445062,270705,170490,472857,294562,155518,100215,139044,0
1461,37121,"Mitchell County, NC",7673,1810,5778,8096,1596,6282,-3968,-4686,0
1462,37123,"Montgomery County, NC",11178,4689,6389,11540,4150,7130,-1700,-2980,0
1463,37125,"Moore County, NC",46044,16371,29336,48692,16329,30490,-12965,-14161,0
1464,37127,"Nash County, NC",48235,24214,23769,47665,23235,23319,445,-84,1
1465,37129,"New Hanover County, NC",102067,48038,52792,111905,50979,55344,-4754,-4365,0
1466,37131,"Northampton County, NC",10719,7210,3474,9848,6144,3582,3736,2562,0
1467,37133,"Onslow County, NC",50353,18115,31695,57135,17514,37122,-13580,-19608,0
1468,37135,"Orange County, NC",75848,53404,21398,82340,59923,18557,32006,41366,0
1469,37137,"Pamlico County, NC",6712,2632,4032,6870,2448,4258,-1400,-1810,0
1470,37139,"Pasquotank County, NC",17343,9970,7216,17391,8615,8180,2754,435,0
1471,37141,"Pender County, NC",24036,9455,14368,27885,9354,17639,-4913,-8285,0
1472,37143,"Perquimans County, NC",6621,2747,3814,6708,2319,4177,-1067,-1858,0
1473,37145,"Person County, NC",19008,8384,10467,19615,7833,11185,-2083,-3352,0
1474,37147,"Pitt County, NC",76814,40701,35534,80527,41824,35691,5167,6133,0
1475,37149,"Polk County, NC",10323,4000,6219,10934,3735,6768,-2219,-3033,0
1476,37151,"Randolph County, NC",60202,14675,44913,64575,13194,49430,-30238,-36236,0
1477,37153,"Richmond County, NC",19127,9747,9236,19328,8501,10383,511,-1882,1
1478,37155,"Robeson County, NC",41380,23957,17093,40858,19016,20762,6864,-1746,1
1479,37157,"Rockingham County, NC",41549,16170,25037,42278,14228,26830,-8867,-12602,0
1480,37159,"Rowan County, NC",61803,22529,38622,64369,19400,42810,-16093,-23410,0
1481,37161,"Rutherford County, NC",28373,9277,18797,30307,7512,21871,-9520,-14359,0
1482,37163,"Sampson County, NC",26005,11496,14358,25928,10547,14838,-2862,-4291,0
1483,37165,"Scotland County, NC",14020,8131,5799,13928,7319,6256,2332,1063,0
1484,37167,"Stanly County, NC",28276,8287,19698,29917,7094,21964,-11411,-14870,0
1485,37169,"Stokes County, NC",21396,5969,15142,22550,4665,17116,-9173,-12451,0
1486,37171,"Surry County, NC",29096,9005,19753,32196,7488,23671,-10748,-16183,0
1487,37173,"Swain County, NC",5705,2618,2976,6124,2196,3565,-358,-1369,0
1488,37175,"Transylvania County, NC",16469,6740,9522,17869,6558,10520,-2782,-3962,0
1489,37177,"Tyrrell County, NC",1775,835,929,1739,720,975,-94,-255,0
1490,37179,"Union County, NC",93389,32032,60468,105710,34337,66707,-28436,-32370,0
1491,37181,"Vance County, NC",20770,13286,7406,19977,12229,7332,5880,4897,0
1492,37183,"Wake County, NC",526805,286939,232933,527624,302736,196082,54006,106654,0
1493,37185,"Warren County, NC",9777,6635,3111,9842,6413,3214,3524,3199,0
1494,37187,"Washington County, NC",6456,3811,2615,6165,3510,2564,1196,946,0
1495,37189,"Watauga County, NC",28168,13371,14124,29985,14138,13697,-753,441,0
1496,37191,"Wayne County, NC",50988,23154,27536,50689,21770,27540,-4382,-5770,0
1497,37193,"Wilkes County, NC",28852,8089,20410,31296,6638,23752,-12321,-17114,0
1498,37195,"Wilson County, NC",38890,20745,17904,38135,19663,17531,2841,2132,0
1499,37197,"Yadkin County, NC",16657,3928,12500,17624,3160,13880,-8572,-10720,0
1500,37199,"Yancey County, NC",9344,3954,5249,9960,3196,6385,-1295,-3189,0
1501,45001,"Abbeville County, SC",10577,4507,5923,10775,3741,6763,-1416,-3022,0
1502,45003,"Aiken County, SC",66049,23953,41157,74851,25455,46025,-17204,-20570,0
1503,45005,"Allendale County, SC",4257,3335,894,3592,2735,789,2441,1946,0
1504,45007,"Anderson County, SC",71901,22315,48493,80483,21097,56232,-26178,-35135,0
1505,45009,"Bamberg County, SC",6854,4600,2190,6214,3898,2204,2410,1694,0
1506,45011,"Barnwell County, SC",9913,5182,4655,9485,4400,4889,527,-489,1
1507,45013,"Beaufort County, SC",73115,29775,42580,78524,32138,42922,-12805,-10784,0
1508,45015,"Berkeley County, SC",61111,24239,35764,79517,30705,44587,-11525,-13882,0
1509,45017,"Calhoun County, SC",7830,4043,3705,7549,3573,3787,338,-214,1
1510,45019,"Charleston County, SC",160854,81027,77248,176345,89299,75443,3779,13856,0
1511,45021,"Cherokee County, SC",20753,7219,13306,21759,6092,15167,-6087,-9075,0
1512,45023,"Chester County, SC",14324,7839,6336,14192,6579,7265,1503,-686,1
1513,45025,"Chesterfield County, SC",16576,7942,8488,16581,6858,9312,-546,-2454,0
1514,45027,"Clarendon County, SC",15985,8967,6890,15395,7732,7386,2077,346,0
1515,45029,"Colleton County, SC",17077,8470,8439,17251,7627,9091,31,-1464,1
1516,45031,"Darlington County, SC",30140,15452,14429,29674,13888,14989,1023,-1101,1
1517,45033,"Dillon County, SC",13186,7623,5477,11698,5834,5637,2146,197,0
1518,45035,"Dorchester County, SC",56735,23390,32469,62567,24055,34987,-9079,-10932,0
1519,45037,"Edgefield County, SC",11583,4965,6511,11644,4491,6842,-1546,-2351,0
1520,45039,"Fairfield County, SC",11858,7743,3996,11267,6945,4027,3747,2918,0
1521,45041,"Florence County, SC",57877,28508,28825,57931,26710,29573,-317,-2863,0
1522,45043,"Georgetown County, SC",30870,14119,16476,31657,13310,17389,-2357,-4079,0
1523,45045,"Greenville County, SC",191282,67378,120514,215165,74483,127832,-53136,-53349,0
1524,45047,"Greenwood County, SC",28525,11884,16290,28763,10711,16961,-4406,-6250,0
1525,45049,"Hampton County, SC",9184,5814,3310,8806,5170,3488,2504,1682,0
1526,45051,"Horry County, SC",104584,36620,66653,132920,39410,89288,-30033,-49878,0
1527,45053,"Jasper County, SC",9991,5727,4169,11427,5956,5187,1558,769,0
1528,45055,"Kershaw County, SC",27026,10821,15846,28995,10330,17542,-5025,-7212,0
1529,45057,"Lancaster County, SC",33010,13345,19273,38938,13812,23719,-5928,-9907,0
1530,45059,"Laurens County, SC",25373,10297,14726,26566,8889,16816,-4429,-7927,0
1531,45061,"Lee County, SC",8898,5972,2829,8156,5199,2803,3143,2396,0
1532,45063,"Lexington County, SC",112204,34007,76392,122093,35230,80026,-42385,-44796,0
1533,45067,"Marion County, SC",14766,9518,5114,14276,8569,5444,4404,3125,0
1534,45069,"Marlboro County, SC",11657,7554,4010,10389,5954,4267,3544,1687,0
1535,45065,"McCormick County, SC",5137,2637,2460,5216,2479,2652,177,-173,1
1536,45071,"Newberry County, SC",16287,6891,9218,16807,6217,10017,-2327,-3800,0
1537,45073,"Oconee County, SC",30613,8537,21573,33635,7998,24178,-13036,-16180,0
1538,45075,"Orangeburg County, SC",42637,30454,11888,38910,26318,11931,18566,14387,0
1539,45077,"Pickens County, SC",45422,11122,33385,49049,10354,36236,-22263,-25882,0
1540,45079,"Richland County, SC",143016,94350,46725,168722,108000,52469,47625,55531,0
1541,45081,"Saluda County, SC",8553,3322,5130,8564,2813,5526,-1808,-2713,0
1542,45083,"Spartanburg County, SC",108327,40920,65951,121090,39997,76277,-25031,-36280,0
1543,45085,"Sumter County, SC",47261,27550,19266,44086,24047,18745,8284,5302,0
1544,45087,"Union County, SC",12475,5748,6566,12092,4729,7061,-818,-2332,0
1545,45089,"Williamsburg County, SC",16282,11318,4819,15054,9953,4864,6499,5089,0
1546,45091,"York County, SC",99428,38757,59149,114357,41593,66754,-20392,-25161,0
1547,47001,"Anderson County, TN",29621,10112,18941,29881,9013,19212,-8829,-10199,0
1548,47003,"Bedford County, TN",14433,4207,10026,15355,3395,11486,-5819,-8091,0
1549,47005,"Benton County, TN",6223,2255,3850,6328,1474,4716,-1595,-3242,0
1550,47007,"Bledsoe County, TN",4359,1267,3022,4664,897,3622,-1755,-2725,0
1551,47009,"Blount County, TN",49200,12925,35417,52208,12100,37443,-22492,-25343,0
1552,47011,"Bradley County, TN",35956,8035,27417,38666,7070,29768,-19382,-22698,0
1553,47013,"Campbell County, TN",12097,3327,8602,12532,2248,9870,-5275,-7622,0
1554,47015,"Cannon County, TN",4968,1560,3308,5314,1127,4007,-1748,-2880,0
1555,47017,"Carroll County, TN",10845,3475,7219,10384,2327,7756,-3744,-5429,0
1556,47019,"Carter County, TN",20607,4786,15496,21084,3453,16898,-10710,-13445,0
1557,47021,"Cheatham County, TN",15177,4656,10266,15924,3878,11297,-5610,-7419,0
1558,47023,"Chester County, TN",6396,1622,4672,6507,1243,5081,-3050,-3838,0
1559,47025,"Claiborne County, TN",10178,2433,7617,10740,1832,8602,-5184,-6770,0
1560,47027,"Clay County, TN",2820,1037,1747,2920,707,2141,-710,-1434,0
1561,47029,"Cocke County, TN",11450,2804,8459,12126,1981,9791,-5655,-7810,0
1562,47031,"Coffee County, TN",19242,5865,13013,19971,4743,14417,-7148,-9674,0
1563,47033,"Crockett County, TN",5497,1669,3782,5397,1303,3982,-2113,-2679,0
1564,47035,"Cumberland County, TN",25244,6260,18651,26360,5202,20413,-12391,-15211,0
1565,47037,"Davidson County, TN",237372,138899,94464,249068,148864,84550,44435,64314,0
1566,47039,"Decatur County, TN",4248,1302,2873,4592,894,3588,-1571,-2694,0
1567,47041,"DeKalb County, TN",6406,2168,4134,6955,1569,5171,-1966,-3602,0
1568,47043,"Dickson County, TN",17821,6228,11287,18699,4722,13233,-5059,-8511,0
1569,47045,"Dyer County, TN",13800,3757,9921,13336,2816,10180,-6164,-7364,0
1570,47047,"Fayette County, TN",19562,6683,12682,19394,5874,13055,-5999,-7181,0
1571,47049,"Fentress County, TN",6890,1559,5240,7333,1100,6038,-3681,-4938,0
1572,47051,"Franklin County, TN",16099,5594,10252,16404,4374,11532,-4658,-7158,0
1573,47053,"Gibson County, TN",19667,6564,12883,19547,5258,13786,-6319,-8528,0
1574,47055,"Giles County, TN",10797,3759,6914,11137,2917,7970,-3155,-5053,0
1575,47057,"Grainger County, TN",7250,1668,5469,8008,1154,6626,-3801,-5472,0
1576,47059,"Greene County, TN",23937,6216,17234,23583,4216,18562,-11018,-14346,0
1577,47061,"Grundy County, TN",4217,1637,2502,4763,999,3636,-865,-2637,0
1578,47063,"Hamblen County, TN",20020,5229,14515,20692,4075,15857,-9286,-11782,0
1579,47065,"Hamilton County, TN",142320,58794,79877,142408,55316,78733,-21083,-23417,0
1580,47067,"Hancock County, TN",2046,475,1527,2231,322,1843,-1052,-1521,0
1581,47069,"Hardeman County, TN",10435,5479,4864,9273,4185,4919,615,-734,1
1582,47071,"Hardin County, TN",10495,2467,7886,9949,1622,8012,-5419,-6390,0
1583,47073,"Hawkins County, TN",19789,5086,14376,20774,3507,16648,-9290,-13141,0
1584,47075,"Haywood County, TN",7567,4567,2960,6834,3711,3013,1607,698,0
1585,47077,"Henderson County, TN",10051,2516,7418,10217,1800,8138,-4902,-6338,0
1586,47079,"Henry County, TN",12731,4337,8187,12945,3063,9508,-3850,-6445,0
1587,47081,"Hickman County, TN",7595,2693,4756,7813,1824,5695,-2063,-3871,0
1588,47083,"Houston County, TN",3027,1400,1579,3168,866,2182,-179,-1316,0
1589,47085,"Humphreys County, TN",6860,2904,3829,7153,1967,4930,-925,-2963,0
1590,47087,"Jackson County, TN",4178,1736,2380,4466,1129,3236,-644,-2107,0
1591,47089,"Jefferson County, TN",17565,4230,13037,19072,3494,14776,-8807,-11282,0
1592,47091,"Johnson County, TN",6194,1483,4611,6579,988,5410,-3128,-4422,0
1593,47093,"Knox County, TN",167330,57594,106411,180697,62878,105767,-48817,-42889,0
1594,47095,"Lake County, TN",2087,884,1163,1970,577,1357,-279,-780,0
1595,47097,"Lauderdale County, TN",8688,4010,4616,8087,3056,4884,-606,-1828,0
1596,47099,"Lawrence County, TN",15219,4237,10770,15666,2821,12420,-6533,-9599,0
1597,47101,"Lewis County, TN",4691,1445,3116,4622,890,3585,-1671,-2695,0
1598,47103,"Lincoln County, TN",13249,3283,9791,13348,2554,10398,-6508,-7844,0
1599,47105,"Loudon County, TN",22066,5057,16701,23391,4919,17610,-11644,-12691,0
1600,47111,"Macon County, TN",6904,1552,5259,7504,1072,6263,-3707,-5191,0
1601,47113,"Madison County, TN",40691,18360,21989,38120,15448,21335,-3629,-5887,0
1602,47115,"Marion County, TN",10404,3952,6268,10862,2832,7696,-2316,-4864,0
1603,47117,"Marshall County, TN",10729,3722,6823,11455,2852,8184,-3101,-5332,0
1604,47119,"Maury County, TN",32989,11819,20698,35369,10038,23799,-8879,-13761,0
1605,47107,"McMinn County, TN",17818,4603,12958,18755,3510,14691,-8355,-11181,0
1606,47109,"McNairy County, TN",9809,2643,7010,10038,1848,7841,-4367,-5993,0
1607,47121,"Meigs County, TN",3958,1163,2728,4320,856,3342,-1565,-2486,0
1608,47123,"Monroe County, TN",16320,4368,11717,17093,3186,13374,-7349,-10188,0
1609,47125,"Montgomery County, TN",55424,24349,30159,57620,21699,32341,-5810,-10642,0
1610,47127,"Moore County, TN",2799,705,2053,2926,496,2325,-1348,-1829,0
1611,47129,"Morgan County, TN",6500,1722,4668,6705,1054,5441,-2946,-4387,0
1612,47131,"Obion County, TN",12296,3320,8814,12249,2426,9526,-5494,-7100,0
1613,47133,"Overton County, TN",7657,2802,4772,8229,1945,6059,-1970,-4114,0
1614,47135,"Perry County, TN",2621,992,1578,2855,597,2167,-586,-1570,0
1615,47137,"Pickett County, TN",2446,711,1707,2615,536,2021,-996,-1485,0
1616,47139,"Polk County, TN",6059,1856,4108,6520,1252,5097,-2252,-3845,0
1617,47141,"Putnam County, TN",25479,7793,17242,27212,6851,19002,-9449,-12151,0
1618,47143,"Rhea County, TN",10578,2625,7793,11062,1942,8660,-5168,-6718,0
1619,47145,"Roane County, TN",21081,6014,14719,21669,4837,15880,-8705,-11043,0
1620,47147,"Robertson County, TN",26285,8289,17641,27113,6637,19410,-9352,-12773,0
1621,47149,"Rutherford County, TN",98816,36400,60829,107436,36706,64515,-24429,-27809,0
1622,47151,"Scott County, TN",6668,1452,5117,7123,934,6044,-3665,-5110,0
1623,47153,"Sequatchie County, TN",5141,1488,3541,5694,1053,4441,-2053,-3388,0
1624,47155,"Sevier County, TN",33856,7415,25979,36312,6297,28629,-18564,-22332,0
1625,47157,"Shelby County, TN",370749,232201,135536,337383,208992,116344,96665,92648,0
1626,47159,"Smith County, TN",7081,2467,4492,7436,1689,5494,-2025,-3805,0
1627,47161,"Stewart County, TN",5115,2069,2963,5299,1222,3864,-894,-2642,0
1628,47163,"Sullivan County, TN",59833,15303,43528,62278,12578,46979,-28225,-34401,0
1629,47165,"Sumner County, TN",65334,18571,45979,71505,18161,50129,-27408,-31968,0
1630,47167,"Tipton County, TN",23682,7020,16395,23481,5785,16910,-9375,-11125,0
1631,47169,"Trousdale County, TN",2901,1238,1610,3160,946,2103,-372,-1157,0
1632,47171,"Unicoi County, TN",7078,1909,5028,7195,1262,5671,-3119,-4409,0
1633,47173,"Union County, TN",5820,1474,4278,6247,1012,5053,-2804,-4041,0
1634,47175,"Van Buren County, TN",2298,875,1384,2419,539,1820,-509,-1281,0
1635,47177,"Warren County, TN",13008,4748,8007,13612,3535,9540,-3259,-6005,0
1636,47179,"Washington County, TN",48003,14318,32787,49750,13024,34252,-18469,-21228,0
1637,47181,"Wayne County, TN",5484,1163,4251,5857,717,5036,-3088,-4319,0
1638,47183,"Weakley County, TN",12332,3547,8601,12184,2772,9008,-5054,-6236,0
1639,47185,"White County, TN",9133,2793,6192,9825,1845,7671,-3399,-5826,0
1640,47187,"Williamson County, TN",93606,24328,68090,106271,31013,68212,-43762,-37199,0
1641,47189,"Wilson County, TN",51437,14669,36076,56734,14385,39406,-21407,-25021,0
1642,39001,"Adams County, OH",10787,3857,6691,11412,2326,8659,-2834,-6333,0
1643,39003,"Allen County, OH",46458,16869,28802,46234,13294,30487,-11933,-17193,0
1644,39005,"Ashland County, OH",23826,8083,15225,24737,5740,17493,-7142,-11753,0
1645,39007,"Ashtabula County, OH",41781,22964,17890,41180,15577,23318,5074,-7741,1
1646,39009,"Athens County, OH",26112,17268,8118,29709,16370,11354,9150,5016,0
1647,39011,"Auglaize County, OH",22838,5643,16802,23794,3980,18658,-11159,-14678,0
1648,39013,"Belmont County, OH",30876,13826,16418,31331,8785,21108,-2592,-12323,0
1649,39015,"Brown County, OH",18955,6923,11671,19682,4353,14573,-4748,-10220,0
1650,39017,"Butler County, OH",164020,59282,102226,174994,58642,106976,-42944,-48334,0
1651,39019,"Carroll County, OH",12965,5396,7177,13148,3154,9254,-1781,-6100,0
1652,39021,"Champaign County, OH",20016,7826,11852,18243,4594,12631,-4026,-8037,0
1653,39023,"Clark County, OH",62136,30022,31116,61893,23328,35205,-1094,-11877,0
1654,39025,"Clermont County, OH",93392,29334,62527,99972,26715,67518,-33193,-40803,0
1655,39027,"Clinton County, OH",17648,5534,11740,18766,4066,13838,-6206,-9772,0
1656,39029,"Columbiana County, OH",45078,19351,24778,46492,12432,31676,-5427,-19244,0
1657,39031,"Coshocton County, OH",15555,6841,8312,15659,4013,10785,-1471,-6772,0
1658,39033,"Crawford County, OH",19192,7207,11561,19329,4625,13611,-4354,-8986,0
1659,39035,"Cuyahoga County, OH",611512,420953,184475,608873,398271,184211,236478,214060,0
1660,39037,"Darke County, OH",24807,6610,17745,25601,4470,20012,-11135,-15542,0
1661,39039,"Defiance County, OH",17744,7438,9935,18349,5368,11688,-2497,-6320,0
1662,39041,"Delaware County, OH",96330,36131,58980,105639,40872,57568,-22849,-16696,0
1663,39043,"Erie County, OH",38262,20969,16655,37862,16057,19648,4314,-3591,1
1664,39045,"Fairfield County, OH",70079,28831,40134,73554,24881,44314,-11303,-19433,0
1665,39047,"Fayette County, OH",10677,4075,6456,11232,2739,7995,-2381,-5256,0
1666,39049,"Franklin County, OH",541751,325654,207941,587524,351198,199331,117713,151867,0
1667,39051,"Fulton County, OH",20757,8790,11521,21353,6069,13709,-2731,-7640,0
1668,39053,"Gallia County, OH",9534,3418,5912,13004,2628,9822,-2494,-7194,0
1669,39055,"Geauga County, OH",50125,19295,30104,50662,17569,30227,-10809,-12658,0
1670,39057,"Greene County, OH",81075,31028,48683,82937,28943,48540,-17655,-19597,0
1671,39059,"Guernsey County, OH",16403,7226,8811,16647,4359,11445,-1585,-7086,0
1672,39061,"Hamilton County, OH",402572,208508,188653,409109,215719,173665,19855,42054,0
1673,39063,"Hancock County, OH",34940,12192,22077,36234,9609,24183,-9885,-14574,0
1674,39065,"Hardin County, OH",12147,4487,7337,12354,2920,8717,-2850,-5797,0
1675,39067,"Harrison County, OH",6999,2895,3936,7105,1688,5098,-1041,-3410,0
1676,39069,"Henry County, OH",13937,5513,8111,14053,3756,9301,-2598,-5545,0
1677,39071,"Highland County, OH",17161,5772,11032,18588,3773,14020,-5260,-10247,0
1678,39073,"Hocking County, OH",12442,6010,6150,12929,3775,8497,-140,-4722,0
1679,39075,"Holmes County, OH",11355,2568,8563,11106,1788,8720,-5995,-6932,0
1680,39077,"Huron County, OH",24077,10673,12821,25002,7192,16226,-2148,-9034,0
1681,39079,"Jackson County, OH",12916,4965,7651,13776,3226,9949,-2686,-6723,0
1682,39081,"Jefferson County, OH",32327,14960,16729,32411,9675,21117,-1769,-11442,0
1683,39083,"Knox County, OH",27618,10154,16873,28927,8171,19131,-6719,-10960,0
1684,39085,"Lake County, OH",114264,55219,57150,117190,46397,64255,-1931,-17858,0
1685,39087,"Lawrence County, OH",25252,10454,14371,26789,6974,18689,-3917,-11715,0
1686,39089,"Licking County, OH",77423,32264,43604,83624,27376,51241,-11340,-23865,0
1687,39091,"Logan County, OH",20535,6789,13323,21712,4647,15957,-6534,-11310,0
1688,39093,"Lorain County, OH",138513,78112,58095,140562,66949,66818,20017,131,0
1689,39095,"Lucas County, OH",200850,129229,68100,198830,110833,75698,61129,35135,0
1690,39097,"Madison County, OH",17240,6700,10215,17421,4779,11631,-3515,-6852,0
1691,39099,"Mahoning County, OH",117571,74298,41702,115958,57381,53616,32596,3765,0
1692,39101,"Marion County, OH",26433,11933,13938,26478,7928,16961,-2005,-9033,0
1693,39103,"Medina County, OH",88849,37841,49464,92163,32182,54810,-11623,-22628,0
1694,39105,"Meigs County, OH",9979,3911,5782,10041,2260,7309,-1871,-5049,0
1695,39107,"Mercer County, OH",21161,4609,16207,21816,3384,17506,-11598,-14122,0
1696,39109,"Miami County, OH",50281,15731,33650,53094,13120,37079,-17919,-23959,0
1697,39111,"Monroe County, OH",6743,3007,3540,6853,1662,4868,-533,-3206,0
1698,39113,"Montgomery County, OH",254266,128983,121188,259876,122016,123909,7795,-1893,1
1699,39115,"Morgan County, OH",6042,2772,3136,6477,1736,4431,-364,-2695,0
1700,39117,"Morrow County, OH",15813,5780,9662,16688,3761,11948,-3882,-8187,0
1701,39119,"Muskingum County, OH",35954,16327,18826,37245,11123,24056,-2499,-12933,0
1702,39121,"Noble County, OH",5755,2082,3498,6039,1221,4549,-1416,-3328,0
1703,39123,"Ottawa County, OH",21936,11214,10323,22385,8285,12653,891,-4368,1
1704,39125,"Paulding County, OH",8912,3435,5248,9095,2093,6500,-1813,-4407,0
1705,39127,"Perry County, OH",14673,6857,7498,15101,4138,10228,-641,-6090,0
1706,39129,"Pickaway County, OH",23443,9335,13713,24912,6529,17076,-4378,-10547,0
1707,39131,"Pike County, OH",11233,5490,5535,11951,3539,7902,-45,-4363,0
1708,39133,"Portage County, OH",74029,38082,34465,76762,32397,39971,3617,-7574,1
1709,39135,"Preble County, OH",19619,6005,13202,20681,4325,15446,-7197,-11121,0
1710,39137,"Putnam County, OH",18126,4238,13563,18857,2922,14961,-9325,-12039,0
1711,39139,"Richland County, OH",55954,21785,33057,55424,16085,36590,-11272,-20505,0
1712,39141,"Ross County, OH",28961,13895,14582,30565,10356,18652,-687,-8296,0
1713,39143,"Sandusky County, OH",28192,14035,13491,28285,9929,16316,544,-6387,1
1714,39145,"Scioto County, OH",30023,14432,15023,31003,9132,20550,-591,-11418,0
1715,39147,"Seneca County, OH",24633,10962,13025,24183,7404,14825,-2063,-7421,0
1716,39149,"Shelby County, OH",23129,6065,16700,23829,4243,18590,-10635,-14347,0
1717,39151,"Stark County, OH",176620,86314,86958,176165,68146,98388,-644,-30242,0
1718,39153,"Summit County, OH",259389,147146,108700,260346,134256,112026,38446,22230,0
1719,39155,"Trumbull County, OH",98703,59446,37545,96676,43014,49024,21901,-6010,1
1720,39157,"Tuscarawas County, OH",39855,17516,21420,41606,12188,26918,-3904,-14730,0
1721,39159,"Union County, OH",24947,8546,15947,27695,7718,18096,-7401,-10378,0
1722,39161,"Van Wert County, OH",13586,3923,9433,13770,2697,10469,-5510,-7772,0
1723,39163,"Vinton County, OH",5352,2382,2798,5540,1351,3883,-416,-2532,0
1724,39165,"Warren County, OH",108008,31907,74626,118309,33730,77643,-42719,-43913,0
1725,39167,"Washington County, OH",28798,11333,16921,30137,8026,20514,-5588,-12488,0
1726,39169,"Wayne County, OH",49356,18932,29450,50217,15031,32270,-10518,-17239,0
1727,39171,"Williams County, OH",17286,7045,9863,17308,4358,11939,-2818,-7581,0
1728,39173,"Wood County, OH",61967,31596,28997,64826,27318,32498,2599,-5180,1
1729,39175,"Wyandot County, OH",10254,3962,6054,10638,2515,7468,-2092,-4953,0
1730,42001,"Adams County, PA",41973,14893,26490,47990,14219,31423,-11597,-17204,0
1731,42003,"Allegheny County, PA",614671,348151,259304,657189,367617,259480,88847,108137,0
1732,42005,"Armstrong County, PA",28322,8694,19231,31864,7178,23484,-10537,-16306,0
1733,42007,"Beaver County, PA",80015,36833,42118,84462,32531,48167,-5285,-15636,0
1734,42009,"Bedford County, PA",21444,4730,16509,23675,3645,19552,-11779,-15907,0
1735,42011,"Berks County, PA",163253,79895,80857,184085,78437,96626,-962,-18189,0
1736,42013,"Blair County, PA",47631,15516,31500,55341,13958,39135,-15984,-25177,0
1737,42015,"Bradford County, PA",22501,8291,13827,25986,6369,18141,-5536,-11772,0
1738,42017,"Bucks County, PA",319407,159598,155876,345042,167060,164361,3722,2699,0
1739,42019,"Butler County, PA",88924,28385,59416,98044,28584,64428,-31031,-35844,0
1740,42021,"Cambria County, PA",57718,23181,33464,63589,18867,42258,-10283,-23391,0
1741,42023,"Cameron County, PA",1967,677,1264,2208,531,1589,-587,-1058,0
1742,42025,"Carbon County, PA",24232,11040,12710,28993,8936,18743,-1670,-9807,0
1743,42027,"Centre County, PA",68801,33677,33697,77307,37088,35274,-20,1814,0
1744,42029,"Chester County, PA",248295,122232,123280,272998,141682,116114,-1048,25568,0
1745,42031,"Clarion County, PA",15227,4731,10228,17660,4273,12576,-5497,-8303,0
1746,42033,"Clearfield County, PA",31894,11093,20303,34550,8200,24932,-9210,-16732,0
1747,42035,"Clinton County, PA",12663,5503,6941,15505,4744,10022,-1438,-5278,0
1748,42037,"Columbia County, PA",24305,10424,13445,28506,8934,18004,-3021,-9070,0
1749,42039,"Crawford County, PA",33089,13024,19497,37813,10971,24987,-6473,-14016,0
1750,42041,"Cumberland County, PA",109964,43983,64365,123486,47085,69076,-20382,-21991,0
1751,42043,"Dauphin County, PA",122625,64209,56838,131783,64706,60863,7371,3843,0
1752,42045,"Delaware County, PA",272853,164805,105270,299336,177402,110667,59535,66735,0
1753,42047,"Elk County, PA",12425,5144,7099,14547,3853,10025,-1955,-6172,0
1754,42049,"Erie County, PA",112732,65136,46102,125129,58112,60069,19034,-1957,1
1755,42051,"Fayette County, PA",48196,21841,25845,54099,17946,34590,-4004,-16644,0
1756,42053,"Forest County, PA",2308,894,1381,2419,626,1683,-487,-1057,0
1757,42055,"Franklin County, PA",62802,18910,43072,70506,17465,49768,-24162,-32303,0
1758,42057,"Fulton County, PA",6148,1297,4780,6822,912,5694,-3483,-4782,0
1759,42059,"Greene County, PA",13726,5564,7985,15868,4482,10849,-2421,-6367,0
1760,42061,"Huntingdon County, PA",17587,5383,11953,19866,4539,14494,-6570,-9955,0
1761,42063,"Indiana County, PA",36180,14403,21187,38122,11528,24888,-6784,-13360,0
1762,42065,"Jefferson County, PA",17072,4535,12288,19595,3650,15192,-7753,-11542,0
1763,42067,"Juniata County, PA",9480,2533,6821,10545,1821,8273,-4288,-6452,0
1764,42069,"Lackawanna County, PA",97116,61309,34730,104404,51983,48384,26579,3599,0
1765,42071,"Lancaster County, PA",219677,87108,129364,244832,91093,137914,-42256,-46821,0
1766,42073,"Lawrence County, PA",38816,17427,20915,41076,14009,25428,-3488,-11419,0
1767,42075,"Lebanon County, PA",53771,18975,34010,62503,18953,40525,-15035,-21572,0
1768,42077,"Lehigh County, PA",144922,77029,66091,162733,81324,73690,10938,7634,0
1769,42079,"Luzerne County, PA",123741,63974,57969,135901,52451,78688,6005,-26237,1
1770,42081,"Lycoming County, PA",46214,15104,30490,51131,13020,35627,-15386,-22607,0
1771,42083,"McKean County, PA",15014,5260,9494,16464,4025,11635,-4234,-7610,0
1772,42085,"Mercer County, PA",48065,23082,24304,52839,18733,31544,-1222,-12811,0
1773,42087,"Mifflin County, PA",16311,4259,11893,18721,3877,14094,-7634,-10217,0
1774,42089,"Monroe County, PA",59312,33431,25100,70008,33918,33386,8331,532,0
1775,42091,"Montgomery County, PA",401787,227561,169903,438652,256082,162731,57658,93351,0
1776,42093,"Montour County, PA",7787,3026,4636,8556,2857,5288,-1610,-2431,0
1777,42095,"Northampton County, PA",125883,65014,59242,144566,66272,71736,5772,-5464,1
1778,42097,"Northumberland County, PA",31512,12392,18516,36888,9788,25427,-6124,-15639,0
1779,42099,"Perry County, PA",18240,5430,12511,21371,4632,15616,-7081,-10984,0
1780,42101,"Philadelphia County, PA",653598,557024,91840,709618,584025,108748,465184,475277,0
1781,42103,"Pike County, PA",23164,10170,12713,26284,9256,16056,-2543,-6800,0
1782,42105,"Potter County, PA",7205,1892,5199,7864,1302,6251,-3307,-4949,0
1783,42107,"Schuylkill County, PA",57505,24453,32156,63385,16770,44001,-7703,-27231,0
1784,42109,"Snyder County, PA",14962,4672,10050,16486,4002,11725,-5378,-7723,0
1785,42111,"Somerset County, PA",33875,9420,23935,36073,7376,27379,-14515,-20003,0
1786,42113,"Sullivan County, PA",2934,1028,1859,3152,750,2291,-831,-1541,0
1787,42115,"Susquehanna County, PA",17930,6891,10735,19043,5123,12891,-3844,-7768,0
1788,42117,"Tioga County, PA",15943,5053,10599,18507,3901,13614,-5546,-9713,0
1789,42119,"Union County, PA",16187,6063,9863,17696,6180,10622,-3800,-4442,0
1790,42121,"Venango County, PA",20775,7469,12928,23530,6309,16021,-5459,-9712,0
1791,42123,"Warren County, PA",16462,6768,9415,18434,5145,12477,-2647,-7332,0
1792,42125,"Washington County, PA",90078,38503,50455,102267,36322,61386,-11952,-25064,0
1793,42127,"Wayne County, PA",20966,8138,12531,24018,7008,16244,-4393,-9236,0
1794,42129,"Westmoreland County, PA",168709,63380,103429,183492,59669,116522,-40049,-56853,0
1795,42131,"Wyoming County, PA",11214,4812,6189,13255,3811,8837,-1377,-5026,0
1796,42133,"York County, PA",186394,72126,111576,208029,68524,128528,-39450,-60004,0
1797,10001,"Kent County, DE",68669,35525,32134,74729,33351,36991,3391,-3640,1
1798,10003,"New Castle County, DE",251960,167051,81226,262979,162919,85525,85825,77394,0
1799,10005,"Sussex County, DE",93215,39971,52116,106106,39333,62611,-12145,-23278,0
1800,27001,"Aitkin County, MN",9109,4412,4533,9231,3134,5516,-121,-2382,0
1801,27003,"Anoka County, MN",185714,88611,93430,185758,75500,93339,-4819,-17839,0
1802,27005,"Becker County, MN",16329,6829,9204,17222,5208,10880,-2375,-5672,0
1803,27007,"Beltrami County, MN",21949,11818,9637,21564,8688,10783,2181,-2095,1
1804,27009,"Benton County, MN",19521,8173,10849,20058,5640,12872,-2676,-7232,0
1805,27011,"Big Stone County, MN",2783,1345,1385,2755,921,1608,-40,-687,0
1806,27013,"Blue Earth County, MN",34039,18164,14916,33593,14428,15667,3248,-1239,1
1807,27015,"Brown County, MN",13882,5630,7938,13779,3763,8708,-2308,-4945,0
1808,27017,"Carlton County, MN",18356,11389,6586,18211,8460,8160,4803,300,0
1809,27019,"Carver County, MN",52747,20745,31155,55696,21508,29056,-10410,-7548,0
1810,27021,"Cass County, MN",16080,6858,8957,15999,4949,9982,-2099,-5033,0
1811,27023,"Chippewa County, MN",6176,3083,2967,6222,1978,3764,116,-1786,1
1812,27025,"Chisago County, MN",29331,12524,16227,30228,9278,18441,-3703,-9163,0
1813,27027,"Clay County, MN",28771,15210,12920,29398,12971,13543,2290,-572,1
1814,27029,"Clearwater County, MN",4183,1753,2359,4245,1100,2925,-606,-1825,0
1815,27031,"Cook County, MN",3304,1993,1221,3395,1912,1156,772,756,0
1816,27033,"Cottonwood County, MN",5848,2433,3316,5721,1678,3679,-883,-2001,0
1817,27035,"Crow Wing County, MN",34800,14760,19415,35842,10982,22287,-4655,-11305,0
1818,27037,"Dakota County, MN",230023,116252,109514,231860,110592,99864,6738,10728,0
1819,27039,"Dodge County, MN",10272,4487,5522,10654,3102,6527,-1035,-3425,0
1820,27041,"Douglas County, MN",20917,8665,11905,21785,6227,13966,-3240,-7739,0
1821,27043,"Faribault County, MN",7689,3407,4104,7412,2153,4659,-697,-2506,0
1822,27045,"Fillmore County, MN",10854,5713,4913,11055,3872,6271,800,-2399,1
1823,27047,"Freeborn County, MN",16645,9327,6970,16051,6041,8808,2357,-2767,1
1824,27049,"Goodhue County, MN",25701,12212,12986,25717,9446,14041,-774,-4595,0
1825,27051,"Grant County, MN",3471,1647,1748,3473,1105,2063,-101,-958,0
1826,27053,"Hennepin County, MN",677965,423979,240073,679977,429288,191770,183906,237518,0
1827,27055,"Houston County, MN",10422,5281,4951,10604,4145,5616,330,-1471,1
1828,27057,"Hubbard County, MN",11482,4676,6622,11505,3423,7261,-1946,-3838,0
1829,27059,"Isanti County, MN",20131,8024,11675,21016,5657,13635,-3651,-7978,0
1830,27061,"Itasca County, MN",23833,12852,10500,23880,9015,12920,2352,-3905,1
1831,27063,"Jackson County, MN",5415,2268,3044,5484,1492,3609,-776,-2117,0
1832,27065,"Kanabec County, MN",8107,3586,4319,8177,2327,5230,-733,-2903,0
1833,27067,"Kandiyohi County, MN",21403,9806,11239,21772,7266,12785,-1433,-5519,0
1834,27069,"Kittson County, MN",2405,1241,1095,2385,823,1349,146,-526,1
1835,27071,"Koochiching County, MN",6432,3451,2841,6363,2306,3569,610,-1263,1
1836,27073,"Lac qui Parle County, MN",3974,1974,1938,3860,1305,2293,36,-988,1
1837,27075,"Lake County, MN",6797,4043,2610,6521,3077,2932,1433,145,0
1838,27077,"Lake of the Woods County, MN",2220,859,1306,2242,553,1540,-447,-987,0
1839,27079,"Le Sueur County, MN",14730,6753,7714,14971,4623,9182,-961,-4559,0
1840,27081,"Lincoln County, MN",3113,1428,1594,3019,860,1931,-166,-1071,0
1841,27083,"Lyon County, MN",12334,5465,6595,12215,3825,7256,-1130,-3431,0
1842,27087,"Mahnomen County, MN",2179,1276,871,2088,930,991,405,-61,1
1843,27089,"Marshall County, MN",4335,1854,2380,4817,1225,3208,-526,-1983,0
1844,27091,"Martin County, MN",10927,4054,6657,10531,2733,7062,-2603,-4329,0
1845,27085,"McLeod County, MN",18455,6970,11069,18807,4978,12155,-4099,-7177,0
1846,27093,"Meeker County, MN",12167,4969,6913,12282,3191,8104,-1944,-4913,0
1847,27095,"Mille Lacs County, MN",13047,5829,6951,13017,3710,8340,-1122,-4630,0
1848,27097,"Morrison County, MN",16662,6153,10159,17614,3637,12925,-4006,-9288,0
1849,27099,"Mower County, MN",18471,11129,6938,17715,7437,8823,4191,-1386,1
1850,27101,"Murray County, MN",4754,2160,2504,4668,1295,2974,-344,-1679,0
1851,27103,"Nicollet County, MN",18285,9652,8214,18097,7886,8437,1438,-551,1
1852,27105,"Nobles County, MN",8493,3793,4581,8632,2733,5299,-788,-2566,0
1853,27107,"Norman County, MN",3199,1730,1384,3261,1264,1699,346,-435,1
1854,27109,"Olmsted County, MN",77951,39338,36832,80129,36268,35668,2506,600,0
1855,27111,"Otter Tail County, MN",31562,12165,18860,32500,9340,20939,-6695,-11599,0
1856,27113,"Pennington County, MN",6493,3024,3304,6715,2147,4000,-280,-1853,0
1857,27115,"Pine County, MN",13904,6750,6845,13811,4580,8191,-95,-3611,0
1858,27117,"Pipestone County, MN",4637,1728,2828,4808,1127,3338,-1100,-2211,0
1859,27119,"Polk County, MN",14644,6773,7615,14796,4712,8979,-842,-4267,0
1860,27121,"Pope County, MN",6224,2981,3142,6319,2106,3793,-161,-1687,0
1861,27123,"Ramsey County, MN",277782,184936,86799,273143,177738,70894,98137,106844,0
1862,27125,"Red Lake County, MN",1963,928,978,1881,540,1141,-50,-601,0
1863,27127,"Redwood County, MN",7761,3008,4570,7611,1887,5137,-1562,-3250,0
1864,27129,"Renville County, MN",7684,3394,4149,7606,2117,4890,-755,-2773,0
1865,27131,"Rice County, MN",32160,17054,14380,32443,14437,15429,2674,-992,1
1866,27133,"Rock County, MN",4830,1945,2810,4839,1373,3091,-865,-1718,0
1867,27135,"Roseau County, MN",7330,2772,4409,7804,1856,5451,-1637,-3595,0
1868,27139,"Scott County, MN",71411,29714,40321,75029,28502,39948,-10607,-11446,0
1869,27141,"Sherburne County, MN",46320,17597,27848,48283,13293,31053,-10251,-17760,0
1870,27143,"Sibley County, MN",7785,2916,4693,7774,1954,5193,-1777,-3239,0
1871,27137,"St. Louis County, MN",116460,74177,39675,112422,57771,44630,34502,13141,0
1872,27145,"Stearns County, MN",78178,33552,43015,79592,25576,47617,-9463,-22041,0
1873,27147,"Steele County, MN",19034,8706,9903,19179,6241,11198,-1197,-4957,0
1874,27149,"Stevens County, MN",5621,2742,2766,5398,2116,2799,-24,-683,0
1875,27151,"Swift County, MN",5087,2751,2248,4994,1686,2963,503,-1277,1
1876,27153,"Todd County, MN",11762,4819,6719,11993,2783,8485,-1900,-5702,0
1877,27155,"Traverse County, MN",1840,942,860,1798,630,1049,82,-419,1
1878,27157,"Wabasha County, MN",11722,5415,6049,11832,3866,6989,-634,-3123,0
1879,27159,"Wadena County, MN",6772,2492,4143,6934,1684,4837,-1651,-3153,0
1880,27161,"Waseca County, MN",9706,4370,5116,9653,2838,5967,-746,-3129,0
1881,27163,"Washington County, MN",141711,70203,69137,144235,67086,64428,1066,2658,0
1882,27165,"Watonwan County, MN",5115,2494,2517,4998,1814,2768,-23,-954,0
1883,27167,"Wilkin County, MN",3212,1258,1884,3302,893,2129,-626,-1236,0
1884,27169,"Winona County, MN",27103,14980,11480,26074,11366,12122,3500,-756,1
1885,27171,"Wright County, MN",69550,26584,41460,69618,20334,43274,-14876,-22940,0
1886,27173,"Yellow Medicine County, MN",5397,2465,2806,5276,1524,3382,-341,-1858,0
1887,54001,"Barbour County, WV",5733,1761,3804,6116,1222,4527,-2043,-3305,0
1888,54003,"Berkeley County, WV",36804,14122,21956,43364,12321,28244,-7834,-15923,0
1889,54005,"Boone County, WV",8434,2777,5414,8779,1790,6504,-2637,-4714,0
1890,54007,"Braxton County, WV",4756,1985,2692,5100,1321,3537,-707,-2216,0
1891,54009,"Brooke County, WV",9224,3984,5014,9696,2568,6625,-1030,-4057,0
1892,54011,"Cabell County, WV",31744,13380,17779,33585,11447,19850,-4399,-8403,0
1893,54013,"Calhoun County, WV",2157,801,1288,2638,456,2035,-487,-1579,0
1894,54015,"Clay County, WV",2989,922,1957,2995,568,2300,-1035,-1732,0
1895,54017,"Doddridge County, WV",2743,571,2108,2863,362,2358,-1537,-1996,0
1896,54019,"Fayette County, WV",13971,5368,8304,15478,4290,10357,-2936,-6067,0
1897,54021,"Gilmer County, WV",2482,830,1580,2579,545,1896,-750,-1351,0
1898,54023,"Grant County, WV",4572,713,3775,4965,512,4346,-3062,-3834,0
1899,54025,"Greenbrier County, WV",12872,4681,7873,14224,3765,9556,-3192,-5791,0
1900,54027,"Hampshire County, WV",7972,2294,5514,8679,1580,6692,-3220,-5112,0
1901,54029,"Hancock County, WV",11991,4571,7159,12802,3262,8909,-2588,-5647,0
1902,54031,"Hardy County, WV",5149,1477,3523,5674,1155,4274,-2046,-3119,0
1903,54033,"Harrison County, WV",25948,9660,15755,28351,7694,18750,-6095,-11056,0
1904,54035,"Jackson County, WV",11465,3824,7360,12304,2663,9020,-3536,-6357,0
1905,54037,"Jefferson County, WV",21776,10215,11090,24508,9518,13204,-875,-3686,0
1906,54039,"Kanawha County, WV",74451,32190,41037,76888,28263,43850,-8847,-15587,0
1907,54041,"Lewis County, WV",6243,1719,4349,6936,1347,5274,-2630,-3927,0
1908,54043,"Lincoln County, WV",6747,2204,4336,7137,1459,5307,-2132,-3848,0
1909,54045,"Logan County, WV",11901,3461,8186,12440,2092,9897,-4725,-7805,0
1910,54049,"Marion County, WV",21414,8905,11981,23364,6964,14668,-3076,-7704,0
1911,54051,"Marshall County, WV",9849,3395,6208,13351,2918,9666,-2813,-6748,0
1912,54053,"Mason County, WV",9713,3738,5706,10269,2081,7654,-1968,-5573,0
1913,54047,"McDowell County, WV",6136,2086,3931,6246,1438,4629,-1845,-3191,0
1914,54055,"Mercer County, WV",21216,5416,15406,23197,4704,17404,-9990,-12700,0
1915,54057,"Mineral County, WV",10784,2836,7687,11671,2050,9070,-4851,-7020,0
1916,54059,"Mingo County, WV",8794,2421,6163,9510,1370,7911,-3742,-6541,0
1917,54061,"Monongalia County, WV",31140,13664,16672,36764,14699,18432,-3008,-3733,0
1918,54063,"Monroe County, WV",5152,1441,3571,5852,1111,4443,-2130,-3332,0
1919,54065,"Morgan County, WV",7037,2361,4508,7737,1573,5732,-2147,-4159,0
1920,54067,"Nicholas County, WV",8676,2635,5823,9579,1840,7251,-3188,-5411,0
1921,54069,"Ohio County, WV",17541,6623,10577,18214,5493,11139,-3954,-5646,0
1922,54071,"Pendleton County, WV",3224,1067,2087,3254,729,2398,-1020,-1669,0
1923,54073,"Pleasants County, WV",2807,942,1805,3179,621,2358,-863,-1737,0
1924,54075,"Pocahontas County, WV",3553,1298,2167,3675,928,2496,-869,-1568,0
1925,54077,"Preston County, WV",11089,2916,7841,12764,2470,9538,-4925,-7068,0
1926,54079,"Putnam County, WV",23501,7198,15926,25211,5884,17788,-8728,-11904,0
1927,54081,"Raleigh County, WV",28499,7651,20375,29892,6443,22048,-12724,-15605,0
1928,54083,"Randolph County, WV",9727,3325,6150,10969,2735,7629,-2825,-4894,0
1929,54085,"Ritchie County, WV",3749,762,2889,4105,496,3405,-2127,-2909,0
1930,54087,"Roane County, WV",5027,1928,2973,5315,1222,3781,-1045,-2559,0
1931,54089,"Summers County, WV",4712,1612,2968,4893,1190,3455,-1356,-2265,0
1932,54091,"Taylor County, WV",5887,1933,3827,6593,1491,4733,-1894,-3242,0
1933,54093,"Tucker County, WV",3118,876,2160,3501,751,2565,-1284,-1814,0
1934,54095,"Tyler County, WV",3245,880,2291,3692,507,2996,-1411,-2489,0
1935,54097,"Upshur County, WV",8195,2143,5878,9298,1766,7005,-3735,-5239,0
1936,54099,"Wayne County, WV",13923,4915,8673,15347,3357,11152,-3758,-7795,0
1937,54101,"Webster County, WV",2744,939,1708,3011,556,2302,-769,-1746,0
1938,54103,"Wetzel County, WV",5808,2194,3449,6312,1359,4519,-1255,-3160,0
1939,54105,"Wirt County, WV",2163,673,1422,2422,386,1911,-749,-1525,0
1940,54107,"Wood County, WV",33600,11067,21980,36063,8400,25434,-10913,-17034,0
1941,54109,"Wyoming County, WV",7496,1575,5751,7880,1062,6547,-4176,-5485,0
1942,38001,"Adams County, ND",1281,328,916,1218,216,909,-588,-693,0
1943,38003,"Barnes County, ND",5471,2389,2953,5344,1597,3160,-564,-1563,0
1944,38005,"Benson County, ND",2148,1232,867,2011,842,929,365,-87,1
1945,38007,"Billings County, ND",577,89,472,605,59,495,-383,-436,0
1946,38009,"Bottineau County, ND",3484,1163,2246,3494,736,2494,-1083,-1758,0
1947,38011,"Bowman County, ND",1728,412,1277,1787,227,1446,-865,-1219,0
1948,38013,"Burke County, ND",1015,230,766,1052,119,895,-536,-776,0
1949,38015,"Burleigh County, ND",42876,14036,27811,47979,10881,32532,-13775,-21651,0
1950,38017,"Cass County, ND",73275,34632,36792,80821,31361,39816,-2160,-8455,0
1951,38019,"Cavalier County, ND",2054,818,1192,2006,476,1357,-374,-881,0
1952,38021,"Dickey County, ND",2513,849,1601,2407,554,1667,-752,-1113,0
1953,38023,"Divide County, ND",1151,382,731,1219,245,867,-349,-622,0
1954,38025,"Dunn County, ND",2002,493,1494,2243,358,1771,-1001,-1413,0
1955,38027,"Eddy County, ND",1147,484,631,1231,355,791,-147,-436,0
1956,38029,"Emmons County, ND",1862,383,1430,1981,215,1677,-1047,-1462,0
1957,38031,"Foster County, ND",1674,604,1028,1719,347,1241,-424,-894,0
1958,38033,"Golden Valley County, ND",924,161,740,957,99,796,-579,-697,0
1959,38035,"Grand Forks County, ND",29796,14008,15044,30365,10851,16340,-1036,-5489,0
1960,38037,"Grant County, ND",1383,331,1012,1381,185,1108,-681,-923,0
1961,38039,"Griggs County, ND",1335,535,770,1265,298,847,-235,-549,0
1962,38041,"Hettinger County, ND",1351,313,998,1296,168,1050,-685,-882,0
1963,38043,"Kidder County, ND",1310,393,870,1376,179,1111,-477,-932,0
1964,38045,"LaMoure County, ND",2179,737,1374,2151,502,1481,-637,-979,0
1965,38047,"Logan County, ND",1042,221,799,1067,114,888,-578,-774,0
1966,38049,"McHenry County, ND",2653,924,1651,2820,490,2050,-727,-1560,0
1967,38051,"McIntosh County, ND",1510,456,1028,1446,235,1100,-572,-865,0
1968,38053,"McKenzie County, ND",3423,926,2450,4672,698,3670,-1524,-2972,0
1969,38055,"McLean County, ND",4894,1660,3130,5315,1081,3860,-1470,-2779,0
1970,38057,"Mercer County, ND",4394,1161,3132,4682,621,3759,-1971,-3138,0
1971,38059,"Morton County, ND",13510,4467,8669,15832,3080,11336,-4202,-8256,0
1972,38061,"Mountrail County, ND",3444,1401,1960,4106,1220,2582,-559,-1362,0
1973,38063,"Nelson County, ND",1668,766,862,1717,536,1025,-96,-489,0
1974,38065,"Oliver County, ND",1010,281,693,1017,119,830,-412,-711,0
1975,38067,"Pembina County, ND",3226,1245,1893,3153,681,2208,-648,-1527,0
1976,38069,"Pierce County, ND",2162,656,1462,2071,431,1437,-806,-1006,0
1977,38071,"Ramsey County, ND",4971,2162,2659,5305,1505,3217,-497,-1712,0
1978,38073,"Ransom County, ND",2412,1341,1008,2359,838,1210,333,-372,1
1979,38075,"Renville County, ND",1272,398,850,1293,201,993,-452,-792,0
1980,38077,"Richland County, ND",7549,3190,4213,7592,2064,4767,-1023,-2703,0
1981,38079,"Rolette County, ND",4528,3351,1090,3755,2099,1217,2261,882,0
1982,38081,"Sargent County, ND",1987,1073,876,1997,694,1088,197,-394,1
1983,38083,"Sheridan County, ND",808,161,637,787,95,650,-476,-555,0
1984,38085,"Sioux County, ND",1138,900,223,1232,758,260,677,498,0
1985,38087,"Slope County, ND",434,83,341,430,43,362,-258,-319,0
1986,38089,"Stark County, ND",11539,2805,8509,12322,1753,9755,-5704,-8002,0
1987,38091,"Steele County, ND",1028,515,495,999,361,538,20,-177,1
1988,38093,"Stutsman County, ND",9431,3561,5641,10155,2498,6718,-2080,-4220,0
1989,38095,"Towner County, ND",1164,511,619,1157,305,733,-108,-428,0
1990,38097,"Traill County, ND",3841,1784,1963,3933,1241,2265,-179,-1024,0
1991,38099,"Walsh County, ND",5061,2118,2809,4636,1167,2995,-691,-1828,0
1992,38101,"Ward County, ND",25231,8412,16176,27412,5806,18636,-7764,-12830,0
1993,38103,"Wells County, ND",2359,671,1646,2383,419,1796,-975,-1377,0
1994,38105,"Williams County, ND",9600,2288,7087,12807,1735,10069,-4799,-8334,0
1995,48001,"Anderson County, TX",16167,3796,12235,16977,3369,13201,-8439,-9832,0
1996,48003,"Andrews County, TX",4476,794,3636,4943,836,3927,-2842,-3091,0
1997,48005,"Angelina County, TX",28403,7833,20301,29911,7538,21668,-12468,-14130,0
1998,48007,"Aransas County, TX",9646,2703,6829,10512,2465,7740,-4126,-5275,0
1999,48009,"Archer County, TX",4163,525,3599,4283,394,3786,-3074,-3392,0
2000,48011,"Armstrong County, TX",935,98,828,1021,70,924,-730,-854,0
2001,48013,"Atascosa County, TX",12704,5128,7451,13673,4651,8618,-2323,-3967,0
2002,48015,"Austin County, TX",11628,2252,9260,12274,2320,9637,-7008,-7317,0
2003,48017,"Bailey County, TX",1813,466,1336,1793,397,1344,-870,-947,0
2004,48019,"Bandera County, TX",9434,1859,7423,10218,1726,8163,-5564,-6437,0
2005,48021,"Bastrop County, TX",24457,9860,14019,28454,10569,16328,-4159,-5759,0
2006,48023,"Baylor County, TX",1592,267,1297,1499,191,1267,-1030,-1076,0
2007,48025,"Bee County, TX",7873,3451,4354,8485,3444,4744,-903,-1300,0
2008,48027,"Bell County, TX",85765,35315,49369,94994,37801,51998,-14054,-14197,0
2009,48029,"Bexar County, TX",511405,263871,240519,589645,319550,240333,23352,79217,0
2010,48031,"Blanco County, TX",4971,1220,3637,5685,1244,4212,-2417,-2968,0
2011,48033,"Borden County, TX",362,32,324,365,31,330,-292,-299,0
2012,48035,"Bosque County, TX",7336,1366,5873,7838,1278,6339,-4507,-5061,0
2013,48037,"Bowie County, TX",35357,10184,24840,34602,8838,24924,-14656,-16086,0
2014,48039,"Brazoria County, TX",106422,34327,70684,121181,43200,72791,-36357,-29591,0
2015,48041,"Brazos County, TX",55845,17440,37152,67211,23121,38738,-19712,-15617,0
2016,48043,"Brewster County, TX",3866,1765,1975,4252,1873,2077,-210,-204,0
2017,48045,"Briscoe County, TX",700,117,576,736,91,625,-459,-534,0
2018,48047,"Brooks County, TX",2403,1886,507,2596,1937,613,1379,1324,0
2019,48049,"Brown County, TX",13936,1904,11894,14026,1621,12017,-9990,-10396,0
2020,48051,"Burleson County, TX",6455,1705,4671,6960,1491,5316,-2966,-3825,0
2021,48053,"Burnet County, TX",16770,3672,12828,19204,3797,14638,-9156,-10841,0
2022,48055,"Caldwell County, TX",11055,4787,6018,12092,4795,6691,-1231,-1896,0
2023,48057,"Calhoun County, TX",6746,2510,4145,6965,2118,4638,-1635,-2520,0
2024,48059,"Callahan County, TX",5195,751,4376,5579,569,4865,-3625,-4296,0
2025,48061,"Cameron County, TX",74802,49159,24955,92079,59402,29472,24204,29930,0
2026,48063,"Camp County, TX",4332,1428,2878,4542,1260,3201,-1450,-1941,0
2027,48065,"Carson County, TX",2775,292,2450,2964,249,2620,-2158,-2371,0
2028,48067,"Cass County, TX",11764,2921,8747,12344,2391,9726,-5826,-7335,0
2029,48069,"Castro County, TX",2119,630,1470,1997,526,1414,-840,-888,0
2030,48071,"Chambers County, TX",14692,2780,11761,16786,2948,13339,-8981,-10391,0
2031,48073,"Cherokee County, TX",16387,3935,12291,16790,3469,12919,-8356,-9450,0
2032,48075,"Childress County, TX",1996,320,1665,2084,253,1802,-1345,-1549,0
2033,48077,"Clay County, TX",5056,740,4266,5018,536,4377,-3526,-3841,0
2034,48079,"Cochran County, TX",916,256,648,901,190,679,-392,-489,0
2035,48081,"Coke County, TX",1406,179,1216,1423,140,1265,-1037,-1125,0
2036,48083,"Coleman County, TX",3483,441,3007,3643,388,3177,-2566,-2789,0
2037,48085,"Collin County, TX",301101,100754,195933,361419,140624,201014,-95179,-60390,0
2038,48087,"Collingsworth County, TX",1150,177,962,1156,145,983,-785,-838,0
2039,48089,"Colorado County, TX",8095,2024,6015,8513,1987,6325,-3991,-4338,0
2040,48091,"Comal County, TX",51475,11437,39291,62178,14238,45136,-27854,-30898,0
2041,48093,"Comanche County, TX",4897,890,3940,5237,789,4333,-3050,-3544,0
2042,48095,"Concho County, TX",1001,194,793,1068,148,885,-599,-737,0
2043,48097,"Cooke County, TX",14291,2240,11901,15955,2352,13181,-9661,-10829,0
2044,48099,"Coryell County, TX",16551,5141,11193,18253,5064,12225,-6052,-7161,0
2045,48101,"Cottle County, TX",739,180,553,612,92,506,-373,-414,0
2046,48103,"Crane County, TX",1283,275,985,1384,299,1049,-710,-750,0
2047,48105,"Crockett County, TX",1457,480,957,1395,372,980,-477,-608,0
2048,48107,"Crosby County, TX",1787,639,1132,1728,468,1181,-493,-713,0
2049,48109,"Culberson County, TX",876,566,294,767,454,280,272,174,0
2050,48111,"Dallam County, TX",1532,253,1248,1544,222,1261,-995,-1039,0
2051,48113,"Dallas County, TX",705941,403170,294339,758973,461080,262945,108831,198135,0
2052,48115,"Dawson County, TX",3640,1017,2591,3563,835,2636,-1574,-1801,0
2053,48123,"DeWitt County, TX",6624,1463,5114,6844,1163,5519,-3651,-4356,0
2054,48117,"Deaf Smith County, TX",4309,1239,3042,4216,1185,2911,-1803,-1726,0
2055,48119,"Delta County, TX",2018,454,1524,2281,400,1836,-1070,-1436,0
2056,48121,"Denton County, TX",240125,79917,156105,298645,110890,170603,-76188,-59713,0
2057,48125,"Dickens County, TX",1019,216,793,909,128,755,-577,-627,0
2058,48127,"Dimmit County, TX",2917,2141,762,3225,2173,974,1379,1199,0
2059,48129,"Donley County, TX",1533,226,1286,1465,191,1225,-1060,-1034,0
2060,48131,"Duval County, TX",4343,3331,979,4168,2783,1316,2352,1467,0
2061,48133,"Eastland County, TX",6494,970,5443,6963,776,6011,-4473,-5235,0
2062,48135,"Ector County, TX",32408,8095,23936,36530,10249,25020,-15841,-14771,0
2063,48137,"Edwards County, TX",883,232,641,1073,303,746,-409,-443,0
2064,48141,"El Paso County, TX",171053,112273,56517,214008,147843,55512,55756,92331,0
2065,48139,"Ellis County, TX",53756,13803,39353,63673,16253,44941,-25550,-28688,0
2066,48143,"Erath County, TX",12467,1965,10325,13893,2160,11210,-8360,-9050,0
2067,48145,"Falls County, TX",5432,2033,3356,5248,1684,3441,-1323,-1757,0
2068,48147,"Fannin County, TX",10781,2482,8143,12044,2132,9548,-5661,-7416,0
2069,48149,"Fayette County, TX",10534,2311,8098,11174,2144,8743,-5787,-6599,0
2070,48151,"Fisher County, TX",1628,512,1094,1729,403,1265,-582,-862,0
2071,48153,"Floyd County, TX",2085,551,1523,1959,435,1474,-972,-1039,0
2072,48155,"Foard County, TX",493,140,346,513,113,383,-206,-270,0
2073,48157,"Fort Bend County, TX",219250,101043,116028,262066,134686,117291,-14985,17395,0
2074,48159,"Franklin County, TX",4255,750,3446,4380,665,3585,-2696,-2920,0
2075,48161,"Freestone County, TX",7562,1848,5644,7684,1471,6026,-3796,-4555,0
2076,48163,"Frio County, TX",3968,2376,1559,4400,2444,1856,817,588,0
2077,48165,"Gaines County, TX",4066,535,3484,4620,597,3907,-2949,-3310,0
2078,48167,"Galveston County, TX",109227,39162,68594,122903,43658,73757,-29432,-30099,0
2079,48169,"Garza County, TX",1556,276,1262,1484,230,1225,-986,-995,0
2080,48171,"Gillespie County, TX",12535,2055,10305,13214,2288,10446,-8250,-8158,0
2081,48173,"Glasscock County, TX",578,44,526,604,34,553,-482,-519,0
2082,48175,"Goliad County, TX",3452,1127,2294,3708,973,2620,-1167,-1647,0
2083,48177,"Gonzales County, TX",6039,1773,4213,6334,1571,4587,-2440,-3016,0
2084,48179,"Gray County, TX",7373,885,6428,7405,701,6500,-5543,-5799,0
2085,48181,"Grayson County, TX",42207,10665,30907,47416,10301,35325,-20242,-25024,0
2086,48183,"Gregg County, TX",41356,12336,28665,41749,11677,28764,-16329,-17087,0
2087,48185,"Grimes County, TX",8598,2339,6141,9533,2194,7065,-3802,-4871,0
2088,48187,"Guadalupe County, TX",49247,15654,32959,57822,18391,36632,-17305,-18241,0
2089,48189,"Hale County, TX",8765,2228,6417,8858,2101,6366,-4189,-4265,0
2090,48191,"Hall County, TX",1108,265,832,1091,164,893,-567,-729,0
2091,48193,"Hamilton County, TX",3551,591,2918,3620,479,3060,-2327,-2581,0
2092,48195,"Hansford County, TX",1960,158,1787,1947,171,1730,-1629,-1559,0
2093,48197,"Hardeman County, TX",1495,302,1176,1513,249,1207,-874,-958,0
2094,48199,"Hardin County, TX",21293,3358,17744,22780,2780,19606,-14386,-16826,0
2095,48201,"Harris County, TX",1185478,585451,584866,1312112,707914,545955,585,161959,0
2096,48203,"Harrison County, TX",26099,8431,17471,26548,7151,18749,-9040,-11598,0
2097,48205,"Hartley County, TX",1904,183,1700,1952,173,1730,-1517,-1557,0
2098,48207,"Haskell County, TX",2006,551,1422,1770,314,1403,-871,-1089,0
2099,48209,"Hays County, TX",58808,25448,31577,72164,33224,33826,-6129,-602,0
2100,48211,"Hemphill County, TX",1509,192,1298,1695,181,1462,-1106,-1281,0
2101,48213,"Henderson County, TX",27582,6094,21202,30045,5669,23650,-15108,-17981,0
2102,48215,"Hidalgo County, TX",138966,97879,39786,173437,118809,48642,58093,70167,0
2103,48217,"Hill County, TX",12032,2745,9128,12970,2547,10108,-6383,-7561,0
2104,48219,"Hockley County, TX",7119,1482,5543,7311,1260,5809,-4061,-4549,0
2105,48221,"Hood County, TX",22445,3829,18341,26262,4008,21382,-14512,-17374,0
2106,48223,"Hopkins County, TX",12742,2775,9834,13538,2510,10707,-7059,-8197,0
2107,48225,"Houston County, TX",8129,2235,5839,8353,1978,6205,-3604,-4227,0
2108,48227,"Howard County, TX",5139,1042,4032,8723,1770,6637,-2990,-4867,0
2109,48229,"Hudspeth County, TX",861,379,471,871,324,503,-92,-179,0
2110,48231,"Hunt County, TX",27984,6658,20976,31554,6396,23910,-14318,-17514,0
2111,48233,"Hutchinson County, TX",7916,1042,6797,8155,854,7042,-5755,-6188,0
2112,48235,"Irion County, TX",788,112,668,766,90,660,-556,-570,0
2113,48237,"Jack County, TX",2907,303,2580,3350,314,2973,-2277,-2659,0
2114,48239,"Jackson County, TX",5018,1068,3903,5302,904,4266,-2835,-3362,0
2115,48241,"Jasper County, TX",13466,3402,9924,13419,2590,10609,-6522,-8019,0
2116,48243,"Jeff Davis County, TX",1188,440,717,1191,422,695,-277,-273,0
2117,48245,"Jefferson County, TX",88548,44626,43214,87618,42443,42862,1412,-419,1
2118,48247,"Jim Hogg County, TX",1667,1301,356,2119,1635,430,945,1205,0
2119,48249,"Jim Wells County, TX",11163,6492,4595,12379,6694,5420,1897,1274,0
2120,48251,"Johnson County, TX",48753,10481,37609,57606,10988,44382,-27128,-33394,0
2121,48253,"Jones County, TX",5562,1225,4258,5960,936,4819,-3033,-3883,0
2122,48255,"Karnes County, TX",4180,1324,2823,4198,1145,2965,-1499,-1820,0
2123,48257,"Kaufman County, TX",34604,9451,24804,41265,10278,29587,-15353,-19309,0
2124,48259,"Kendall County, TX",17729,3035,14467,20120,3643,15700,-11432,-12057,0
2125,48261,"Kenedy County, TX",166,82,83,186,99,84,-1,15,0
2126,48263,"Kent County, TX",404,66,334,434,59,360,-268,-301,0
2127,48265,"Kerr County, TX",21811,4325,17225,23297,4681,17727,-12900,-13046,0
2128,48267,"Kimble County, TX",1891,217,1667,1952,206,1697,-1450,-1491,0
2129,48269,"King County, TX",145,5,139,159,5,149,-134,-144,0
2130,48271,"Kinney County, TX",1425,522,880,1430,458,936,-358,-478,0
2131,48273,"Kleberg County, TX",8902,4752,4056,9512,4716,4367,696,349,0
2132,48275,"Knox County, TX",1510,332,1160,1367,247,1078,-828,-831,0
2133,48283,"La Salle County, TX",1646,965,669,2059,1129,872,296,257,0
2134,48285,"Lavaca County, TX",8279,1427,6788,8661,1170,7347,-5361,-6177,0
2135,48277,"Lamar County, TX",17173,4173,12814,18611,3583,14561,-8641,-10978,0
2136,48279,"Lamb County, TX",4089,998,3056,3995,771,3111,-2058,-2340,0
2137,48281,"Lampasas County, TX",7138,1457,5583,8205,1483,6385,-4126,-4902,0
2138,48287,"Lee County, TX",6211,1630,4504,6535,1372,4997,-2874,-3625,0
2139,48289,"Leon County, TX",6941,1061,5812,7439,909,6391,-4751,-5482,0
2140,48291,"Liberty County, TX",22711,5196,17304,24267,4862,18892,-12108,-14030,0
2141,48293,"Limestone County, TX",7563,2208,5288,7739,1778,5796,-3080,-4018,0
2142,48295,"Lipscomb County, TX",1168,119,1044,1332,135,1159,-925,-1024,0
2143,48297,"Live Oak County, TX",4108,915,3153,4302,742,3464,-2238,-2722,0
2144,48299,"Llano County, TX",9502,1818,7560,10447,1825,8299,-5742,-6474,0
2145,48301,"Loving County, TX",64,9,54,65,4,58,-45,-54,0
2146,48303,"Lubbock County, TX",90615,26088,63133,99013,28023,65651,-37045,-37628,0
2147,48305,"Lynn County, TX",1852,464,1377,2009,403,1546,-913,-1143,0
2148,48313,"Madison County, TX",4025,964,3028,4289,881,3351,-2064,-2470,0
2149,48315,"Marion County, TX",4271,1487,2730,4238,1165,2983,-1243,-1818,0
2150,48317,"Martin County, TX",1593,247,1338,1762,266,1455,-1091,-1189,0
2151,48319,"Mason County, TX",1965,380,1562,2057,354,1656,-1182,-1302,0
2152,48321,"Matagorda County, TX",12110,3972,8026,12196,3500,8366,-4054,-4866,0
2153,48323,"Maverick County, TX",10562,8302,2171,13588,10397,2816,6131,7581,0
2154,48307,"McCulloch County, TX",2993,537,2419,3103,482,2552,-1882,-2070,0
2155,48309,"McLennan County, TX",74493,25688,47885,79075,27063,48260,-22197,-21197,0
2156,48311,"McMullen County, TX",508,67,436,499,40,454,-369,-414,0
2157,48325,"Medina County, TX",15948,4760,11016,17246,4634,12085,-6256,-7451,0
2158,48327,"Menard County, TX",846,170,663,864,154,682,-493,-528,0
2159,48329,"Midland County, TX",44277,8223,35452,49212,10025,36973,-27229,-26948,0
2160,48331,"Milam County, TX",8220,2632,5478,8664,2051,6364,-2846,-4313,0
2161,48333,"Mills County, TX",2197,279,1882,2245,243,1951,-1603,-1708,0
2162,48335,"Mitchell County, TX",2312,536,1754,2196,354,1780,-1218,-1426,0
2163,48337,"Montague County, TX",7737,1116,6539,8604,885,7526,-5423,-6641,0
2164,48339,"Montgomery County, TX",172820,32852,137822,204632,45835,150314,-104970,-104479,0
2165,48341,"Moore County, TX",4983,963,3967,5284,1098,3977,-3004,-2879,0
2166,48343,"Morris County, TX",5129,1856,3226,4973,1425,3446,-1370,-2021,0
2167,48345,"Motley County, TX",599,55,538,615,40,566,-483,-526,0
2168,48347,"Nacogdoches County, TX",20601,6441,13910,22622,6846,14771,-7469,-7925,0
2169,48349,"Navarro County, TX",15316,4348,10838,16433,4002,11994,-6490,-7992,0
2170,48351,"Newton County, TX",6188,1721,4399,5534,1156,4288,-2678,-3132,0
2171,48353,"Nolan County, TX",4567,1216,3277,4857,1029,3552,-2061,-2523,0
2172,48355,"Nueces County, TX",95781,45666,48779,104405,49198,50766,-3113,-1568,0
2173,48357,"Ochiltree County, TX",2990,253,2718,3002,274,2628,-2465,-2354,0
2174,48359,"Oldham County, TX",865,71,786,948,78,850,-715,-772,0
2175,48361,"Orange County, TX",30502,6797,23361,32000,5735,25513,-16564,-19778,0
2176,48363,"Palo Pinto County, TX",9335,1810,7392,10270,1708,8284,-5582,-6576,0
2177,48365,"Panola County, TX",10221,2211,7941,10416,1835,8445,-5730,-6610,0
2178,48367,"Parker County, TX",47346,7804,38980,56817,8344,46473,-31176,-38129,0
2179,48369,"Parmer County, TX",2545,528,2005,2466,485,1915,-1477,-1430,0
2180,48371,"Pecos County, TX",4147,1591,2512,4185,1554,2468,-921,-914,0
2181,48373,"Polk County, TX",19058,4836,14019,19852,4187,15176,-9183,-10989,0
2182,48375,"Potter County, TX",26418,7114,18905,28651,7657,19630,-11791,-11973,0
2183,48377,"Presidio County, TX",1808,1273,504,2208,1458,652,769,806,0
2184,48379,"Rains County, TX",4065,754,3265,4701,628,3968,-2511,-3340,0
2185,48381,"Randall County, TX",49588,7553,41366,54305,8367,43462,-33813,-35095,0
2186,48383,"Reagan County, TX",843,158,676,904,167,709,-518,-542,0
2187,48385,"Real County, TX",1533,277,1236,1681,262,1382,-959,-1120,0
2188,48387,"Red River County, TX",5074,1482,3549,5161,1149,3926,-2067,-2777,0
2189,48389,"Reeves County, TX",2867,1649,1185,3184,1659,1417,464,242,0
2190,48391,"Refugio County, TX",2673,998,1659,2948,1034,1830,-661,-796,0
2191,48393,"Roberts County, TX",439,25,408,554,20,524,-383,-504,0
2192,48395,"Robertson County, TX",7278,2792,4416,7035,2203,4668,-1624,-2465,0
2193,48397,"Rockwall County, TX",35651,8112,27098,39948,9655,28451,-18986,-18796,0
2194,48399,"Runnels County, TX",3665,517,3103,3782,453,3250,-2586,-2797,0
2195,48401,"Rusk County, TX",18537,4451,13924,18994,3935,14675,-9473,-10740,0
2196,48403,"Sabine County, TX",4572,806,3726,4651,614,3998,-2920,-3384,0
2197,48405,"San Augustine County, TX",3690,1193,2469,3569,910,2622,-1276,-1712,0
2198,48407,"San Jacinto County, TX",9610,2410,7105,10343,2038,8059,-4695,-6021,0
2199,48409,"San Patricio County, TX",20064,7854,11994,21656,7871,13030,-4140,-5159,0
2200,48411,"San Saba County, TX",2256,323,1905,2357,293,2025,-1582,-1732,0
2201,48413,"Schleicher County, TX",1010,220,781,1059,208,821,-561,-613,0
2202,48415,"Scurry County, TX",5022,837,4121,5289,733,4410,-3284,-3677,0
2203,48417,"Shackelford County, TX",1363,131,1218,1504,103,1378,-1087,-1275,0
2204,48419,"Shelby County, TX",9261,2318,6870,9086,1758,7179,-4552,-5421,0
2205,48421,"Sherman County, TX",1038,121,908,935,96,807,-787,-711,0
2206,48423,"Smith County, TX",84794,22101,61858,84768,22300,58930,-39757,-36630,0
2207,48425,"Somervell County, TX",3507,609,2858,3897,541,3206,-2249,-2665,0
2208,48427,"Starr County, TX",11859,10248,1540,11740,9289,2224,8708,7065,0
2209,48429,"Stephens County, TX",3407,475,2891,3461,348,3034,-2416,-2686,0
2210,48431,"Sterling County, TX",494,31,459,633,70,549,-428,-479,0
2211,48433,"Stonewall County, TX",675,160,507,701,135,555,-347,-420,0
2212,48435,"Sutton County, TX",1489,369,1110,1416,313,1075,-741,-762,0
2213,48437,"Swisher County, TX",2265,579,1654,2204,462,1671,-1075,-1209,0
2214,48439,"Tarrant County, TX",610149,252789,348686,668514,288392,345921,-95897,-57529,0
2215,48441,"Taylor County, TX",43170,9725,32853,45759,10085,33250,-23128,-23165,0
2216,48443,"Terrell County, TX",553,184,358,438,140,288,-174,-148,0
2217,48445,"Terry County, TX",3707,1059,2602,3355,753,2459,-1543,-1706,0
2218,48447,"Throckmorton County, TX",813,109,700,808,84,715,-591,-631,0
2219,48449,"Titus County, TX",8790,2638,6062,9419,2597,6511,-3424,-3914,0
2220,48451,"Tom Green County, TX",36527,9246,26749,38479,9173,27494,-17503,-18321,0
2221,48453,"Travis County, TX",384890,231540,139503,468720,308260,127209,92037,181051,0
2222,48455,"Trinity County, TX",6234,1614,4537,5985,1154,4737,-2923,-3583,0
2223,48457,"Tyler County, TX",7623,1659,5889,8016,1248,6624,-4230,-5376,0
2224,48459,"Upshur County, TX",15049,2953,11948,16013,2380,13209,-8995,-10829,0
2225,48461,"Upton County, TX",1298,332,952,1347,286,1007,-620,-721,0
2226,48463,"Uvalde County, TX",8431,3824,4526,8964,3867,4835,-702,-968,0
2227,48465,"Val Verde County, TX",12040,6267,5612,13617,6964,5890,655,1074,0
2228,48467,"Van Zandt County, TX",19081,3083,15790,21890,2799,18473,-12707,-15674,0
2229,48469,"Victoria County, TX",28827,8795,19684,31123,8866,21275,-10889,-12409,0
2230,48471,"Walker County, TX",15066,5283,9569,19796,6091,12884,-4286,-6793,0
2231,48473,"Waller County, TX",15699,6401,9158,16784,5748,10531,-2757,-4783,0
2232,48475,"Ward County, TX",3238,836,2364,3445,783,2547,-1528,-1764,0
2233,48477,"Washington County, TX",14373,3378,10850,14828,3382,10945,-7472,-7563,0
2234,48479,"Webb County, TX",49101,37592,11074,56905,42307,12947,26518,29360,0
2235,48481,"Wharton County, TX",14087,4235,9750,14732,4238,10149,-5515,-5911,0
2236,48483,"Wheeler County, TX",2128,232,1878,2306,194,2087,-1646,-1893,0
2237,48485,"Wichita County, TX",40923,10490,29756,38119,8770,27631,-19266,-18861,0
2238,48487,"Wilbarger County, TX",3980,971,2956,4105,809,3166,-1985,-2357,0
2239,48489,"Willacy County, TX",5058,3595,1415,5095,3422,1547,2180,1875,0
2240,48491,"Williamson County, TX",162936,61812,96910,203081,84468,104175,-35098,-19707,0
2241,48493,"Wilson County, TX",17186,4819,12205,19432,4790,13998,-7386,-9208,0
2242,48495,"Winkler County, TX",1745,398,1331,1876,420,1403,-933,-983,0
2243,48497,"Wise County, TX",20692,3219,17178,24776,3412,20670,-13959,-17258,0
2244,48499,"Wood County, TX",17541,3052,14317,18727,2630,15700,-11265,-13070,0
2245,48501,"Yoakum County, TX",2128,409,1698,2303,426,1797,-1289,-1371,0
2246,48503,"Young County, TX",7316,992,6225,7707,876,6601,-5233,-5725,0
2247,48505,"Zapata County, TX",3529,2517,993,3142,2063,1029,1524,1034,0
2248,48507,"Zavala County, TX",3653,3042,574,3396,2636,694,2468,1942,0
2249,29001,"Adair County, MO",10121,4218,5648,10226,3500,6030,-1430,-2530,0
2250,29003,"Andrew County, MO",8306,2649,5457,9194,2045,6665,-2808,-4620,0
2251,29005,"Atchison County, MO",2709,756,1902,2730,541,2060,-1146,-1519,0
2252,29007,"Audrain County, MO",9951,3538,6186,10133,2570,6981,-2648,-4411,0
2253,29009,"Barry County, MO",13806,3667,9832,14605,2710,11428,-6165,-8718,0
2254,29011,"Barton County, MO",5746,1232,4416,5939,795,4959,-3184,-4164,0
2255,29013,"Bates County, MO",7771,2557,5020,8083,1618,6001,-2463,-4383,0
2256,29015,"Benton County, MO",9157,2925,6069,9590,2025,7213,-3144,-5188,0
2257,29017,"Bollinger County, MO",5455,1213,4094,5676,705,4827,-2881,-4122,0
2258,29019,"Boone County, MO",79296,39782,37343,83868,41125,36200,2439,4925,0
2259,29021,"Buchanan County, MO",35106,15594,18660,35964,12013,21320,-3066,-9307,0
2260,29023,"Butler County, MO",16889,4363,12248,17259,3036,13650,-7885,-10614,0
2261,29025,"Caldwell County, MO",4171,1313,2724,4312,838,3232,-1411,-2394,0
2262,29027,"Callaway County, MO",18228,6070,11742,19333,4989,13057,-5672,-8068,0
2263,29029,"Camden County, MO",21942,6458,15089,22637,4768,16944,-8631,-12176,0
2264,29031,"Cape Girardeau County, MO",35672,9713,25343,37311,8492,27017,-15630,-18525,0
2265,29033,"Carroll County, MO",4304,1154,3072,4361,745,3480,-1918,-2735,0
2266,29035,"Carter County, MO",2799,754,1978,2850,436,2324,-1224,-1888,0
2267,29037,"Cass County, MO",48913,17044,30912,51409,14846,33098,-13868,-18252,0
2268,29039,"Cedar County, MO",6043,1536,4375,6327,1011,5021,-2839,-4010,0
2269,29041,"Chariton County, MO",3821,1339,2402,3969,888,2950,-1063,-2062,0
2270,29043,"Christian County, MO",37952,9809,27465,41863,8508,30946,-17656,-22438,0
2271,29045,"Clark County, MO",3225,1398,1730,3316,724,2458,-332,-1734,0
2272,29047,"Clay County, MO",105465,47250,56131,111170,45304,57476,-8881,-12172,0
2273,29049,"Clinton County, MO",9830,3685,5904,10301,2572,7067,-2219,-4495,0
2274,29051,"Cole County, MO",37058,12003,24488,37656,10913,24616,-12485,-13703,0
2275,29053,"Cooper County, MO",7511,2474,4887,7986,1932,5624,-2413,-3692,0
2276,29055,"Crawford County, MO",9579,2951,6434,9920,1824,7724,-3483,-5900,0
2277,29057,"Dade County, MO",3896,939,2895,3951,637,3184,-1956,-2547,0
2278,29059,"Dallas County, MO",7279,2122,4992,7453,1272,5895,-2870,-4623,0
2279,29061,"Daviess County, MO",3512,1124,2282,3738,730,2767,-1158,-2037,0
2280,29063,"DeKalb County, MO",4350,1194,3056,4626,824,3540,-1862,-2716,0
2281,29065,"Dent County, MO",6643,1585,4883,6791,978,5600,-3298,-4622,0
2282,29067,"Douglas County, MO",6556,1709,4649,6666,984,5486,-2940,-4502,0
2283,29069,"Dunklin County, MO",10649,3635,6849,10578,2360,8026,-3214,-5666,0
2284,29071,"Franklin County, MO",46573,16294,29271,50472,12341,35430,-12977,-23089,0
2285,29073,"Gasconade County, MO",7134,2099,4895,7451,1520,5670,-2796,-4150,0
2286,29075,"Gentry County, MO",2997,937,1986,3043,605,2304,-1049,-1699,0
2287,29077,"Greene County, MO",125639,46130,76786,130523,42728,78035,-30656,-35307,0
2288,29079,"Grundy County, MO",4374,1212,3030,4428,780,3462,-1818,-2682,0
2289,29081,"Harrison County, MO",3695,984,2624,3689,574,2965,-1640,-2391,0
2290,29083,"Henry County, MO",10121,3604,6229,9912,2357,7075,-2625,-4718,0
2291,29085,"Hickory County, MO",4680,1733,2835,4724,1016,3542,-1102,-2526,0
2292,29087,"Holt County, MO",2310,551,1725,2355,347,1926,-1174,-1579,0
2293,29089,"Howard County, MO",4861,1722,3012,4868,1283,3277,-1290,-1994,0
2294,29091,"Howell County, MO",16341,4393,11541,17455,2881,13893,-7148,-11012,0
2295,29093,"Iron County, MO",4031,1669,2252,4269,933,3173,-583,-2240,0
2296,29095,"Jackson County, MO",306854,180100,121891,304687,168972,116211,58209,52761,0
2297,29097,"Jasper County, MO",45213,12808,31345,48326,10572,35070,-18537,-24498,0
2298,29099,"Jefferson County, MO",97613,41570,53973,106995,31568,69036,-12403,-37468,0
2299,29101,"Johnson County, MO",21001,7661,12750,21362,5930,13719,-5089,-7789,0
2300,29103,"Knox County, MO",1957,698,1205,1870,379,1416,-507,-1037,0
2301,29105,"Laclede County, MO",15361,4093,10934,16140,2553,12881,-6841,-10328,0
2302,29107,"Lafayette County, MO",15786,5650,9800,15975,4053,10988,-4150,-6935,0
2303,29109,"Lawrence County, MO",15748,4014,11417,16811,2901,13089,-7403,-10188,0
2304,29111,"Lewis County, MO",4278,1507,2677,4480,934,3344,-1170,-2410,0
2305,29113,"Lincoln County, MO",22649,7733,14330,25114,5575,18159,-6597,-12584,0
2306,29115,"Linn County, MO",5527,2031,3331,5587,1240,4088,-1300,-2848,0
2307,29117,"Livingston County, MO",6054,1906,4006,6421,1265,4879,-2100,-3614,0
2308,29121,"Macon County, MO",7159,2309,4700,7631,1548,5798,-2391,-4250,0
2309,29123,"Madison County, MO",4930,1588,3227,5321,1005,4102,-1639,-3097,0
2310,29125,"Maries County, MO",4538,1299,3165,4500,794,3561,-1866,-2767,0
2311,29127,"Marion County, MO",12164,4034,7926,12938,2994,9419,-3892,-6425,0
2312,29119,"McDonald County, MO",7817,1920,5694,8242,1329,6599,-3774,-5270,0
2313,29129,"Mercer County, MO",1655,353,1255,1745,216,1486,-902,-1270,0
2314,29131,"Miller County, MO",11019,2651,8099,11482,1750,9285,-5448,-7535,0
2315,29133,"Mississippi County, MO",4918,1857,2996,5169,1458,3600,-1139,-2142,0
2316,29135,"Moniteau County, MO",6442,1608,4703,6830,1237,5347,-3095,-4110,0
2317,29137,"Monroe County, MO",4057,1398,2564,4156,853,3159,-1166,-2306,0
2318,29139,"Montgomery County, MO",5317,1734,3486,5429,1119,4127,-1752,-3008,0
2319,29141,"Morgan County, MO",8688,2773,5733,8821,1768,6760,-2960,-4992,0
2320,29143,"New Madrid County, MO",7250,2814,4284,7357,1933,5270,-1470,-3337,0
2321,29145,"Newton County, MO",25080,6425,18179,26807,4990,20553,-11754,-15563,0
2322,29147,"Nodaway County, MO",8976,3172,5593,9458,2529,6380,-2421,-3851,0
2323,29149,"Oregon County, MO",4421,1419,2886,4668,865,3671,-1467,-2806,0
2324,29151,"Osage County, MO",6918,1472,5330,7090,998,5856,-3858,-4858,0
2325,29153,"Ozark County, MO",4453,1261,3080,4505,724,3639,-1819,-2915,0
2326,29155,"Pemiscot County, MO",6333,2671,3596,6027,1947,3964,-925,-2017,0
2327,29157,"Perry County, MO",7987,2184,5669,8740,1520,6908,-3485,-5388,0
2328,29159,"Pettis County, MO",17171,5902,10840,18204,4324,12810,-4938,-8486,0
2329,29161,"Phelps County, MO",18188,5798,11893,18713,4766,12709,-6095,-7943,0
2330,29163,"Pike County, MO",7319,2581,4576,7382,1806,5274,-1995,-3468,0
2331,29165,"Platte County, MO",45547,19171,25617,49608,20057,25933,-6446,-5876,0
2332,29167,"Polk County, MO",13119,3580,9252,13763,2631,10438,-5672,-7807,0
2333,29169,"Pulaski County, MO",13571,4199,9092,13488,2922,9876,-4893,-6954,0
2334,29171,"Putnam County, MO",2309,587,1673,2346,353,1936,-1086,-1583,0
2335,29173,"Ralls County, MO",5036,1736,3231,5294,1138,3969,-1495,-2831,0
2336,29175,"Randolph County, MO",9944,3031,6667,10309,2283,7529,-3636,-5246,0
2337,29177,"Ray County, MO",10346,4264,5805,10869,3090,7104,-1541,-4014,0
2338,29179,"Reynolds County, MO",3196,1155,1927,3038,540,2406,-772,-1866,0
2339,29181,"Ripley County, MO",5263,1396,3743,5524,830,4522,-2347,-3692,0
2340,29195,"Saline County, MO",9095,3785,5096,9274,2789,5977,-1311,-3188,0
2341,29197,"Schuyler County, MO",1939,697,1174,1936,354,1505,-477,-1151,0
2342,29199,"Scotland County, MO",1936,643,1246,1968,365,1525,-603,-1160,0
2343,29201,"Scott County, MO",16999,5122,11623,17337,3575,13168,-6501,-9593,0
2344,29203,"Shannon County, MO",3688,1300,2260,3904,776,2966,-960,-2190,0
2345,29205,"Shelby County, MO",3232,966,2188,3274,606,2524,-1222,-1918,0
2346,29183,"St. Charles County, MO",185597,71798,110732,203168,68626,121650,-38934,-53024,0
2347,29185,"St. Clair County, MO",4626,1460,3019,4630,936,3501,-1559,-2565,0
2348,29187,"St. Francois County, MO",22590,8837,13248,24920,6250,17468,-4411,-11218,0
2349,29510,"St. Louis city, MO",141135,116654,22617,132487,104235,20832,94037,83403,0
2350,29189,"St. Louis County, MO",524628,294735,223102,519686,286704,202434,71633,84270,0
2351,29186,"Ste. Genevieve County, MO",8070,3813,4055,8469,2542,5496,-242,-2954,0
2352,29207,"Stoddard County, MO",12866,3153,9496,13291,1876,11079,-6343,-9203,0
2353,29209,"Stone County, MO",15974,3920,11780,16645,2887,13158,-7860,-10271,0
2354,29211,"Sullivan County, MO",2595,908,1610,2486,526,1884,-702,-1358,0
2355,29213,"Taney County, MO",21608,5462,15713,23673,4373,18276,-10251,-13903,0
2356,29215,"Texas County, MO",10764,2871,7618,10956,1728,8875,-4747,-7147,0
2357,29217,"Vernon County, MO",8519,2580,5756,8631,1707,6533,-3176,-4826,0
2358,29219,"Warren County, MO",14676,5219,9150,15784,3915,11111,-3931,-7196,0
2359,29221,"Washington County, MO",8616,3402,5008,9282,1926,7048,-1606,-5122,0
2360,29223,"Wayne County, MO",5718,1811,3790,5762,948,4658,-1979,-3710,0
2361,29225,"Webster County, MO",15421,4407,10702,16743,3177,12840,-6295,-9663,0
2362,29227,"Worth County, MO",1048,341,664,1046,195,808,-323,-613,0
2363,29229,"Wright County, MO",7956,1953,5831,8119,1170,6707,-3878,-5537,0
2364,34001,"Atlantic County, NJ",102405,59509,41918,118041,60924,52690,17591,8234,0
2365,34003,"Bergen County, NJ",352023,193470,155267,422213,231211,175529,38203,55682,0
2366,34005,"Burlington County, NJ",197059,115951,79110,221283,121725,89272,36841,32453,0
2367,34007,"Camden County, NJ",203201,137795,63329,229047,146717,72631,74466,74086,0
2368,34009,"Cape May County, NJ",47243,21275,25488,49257,18750,28446,-4213,-9696,0
2369,34011,"Cumberland County, NJ",49472,30172,18767,54331,27771,24453,11405,3318,0
2370,34013,"Essex County, NJ",281633,217950,61595,312884,240837,63176,156355,177661,0
2371,34015,"Gloucester County, NJ",133568,72960,58915,141254,66870,67544,14045,-674,1
2372,34017,"Hudson County, NJ",176104,136239,38082,220542,163917,49043,98157,114874,0
2373,34019,"Hunterdon County, NJ",62821,25148,36979,71660,28898,38712,-11831,-9814,0
2374,34021,"Mercer County, NJ",139064,94300,43155,158058,104775,46193,51145,58582,0
2375,34023,"Middlesex County, NJ",285232,179515,102472,328557,193044,122953,77043,70091,0
2376,34025,"Monmouth County, NJ",268943,125471,140376,317750,137181,166723,-14905,-29542,0
2377,34027,"Morris County, NJ",206580,90313,114265,253537,115249,126071,-23952,-10822,0
2378,34029,"Ocean County, NJ",237432,96500,138594,276725,87150,179079,-42094,-91929,0
2379,34031,"Passaic County, NJ",164629,104057,59181,196228,116759,72902,44876,43857,0
2380,34033,"Salem County, NJ",29116,14456,14214,29853,11904,16381,242,-4477,1
2381,34035,"Somerset County, NJ",134932,70168,63159,157092,85689,65505,7009,20184,0
2382,34037,"Sussex County, NJ",61704,23406,37215,75158,24212,46658,-13809,-22446,0
2383,34039,"Union County, NJ",202353,134220,66457,223570,147414,68114,67763,79300,0
2384,34041,"Warren County, NJ",43312,17869,24695,49683,17281,29858,-6826,-12577,0
2385,2000,AK,247483,102138,136848,246588,93007,130415,-34710,-37408,0
2386,44001,"Bristol County, RI",24563,14943,9216,25475,14609,8965,5727,5644,0
2387,44003,"Kent County, RI",77247,44966,30786,82053,37788,38336,14180,-548,1
2388,44005,"Newport County, RI",40545,23507,16343,41045,22851,15077,7164,7774,0
2389,44007,"Providence County, RI",234092,156022,74344,248474,142899,90882,81678,52017,0
2390,44009,"Washington County, RI",60933,34904,24666,66369,33741,27230,10238,6511,0
2391,15001,"Hawaii County, HI",62653,46670,14541,64867,41259,17501,32129,23758,0
2392,15003,"Honolulu County, HI",292925,201803,87255,285790,175696,90326,114548,85370,0
2393,15007,"Kauai County, HI",25369,18638,6121,26335,16456,7574,12517,8882,0
2394,15009,"Maui County, HI",48547,35979,11577,51945,33480,13446,24402,20034,0
2395,25001,"Barnstable County, MA",132212,70329,60221,135781,72430,54099,10108,18331,0
2396,25003,"Berkshire County, MA",64078,48596,14209,65617,43714,16839,34387,26875,0
2397,25005,"Bristol County, MA",239565,142481,93448,252140,129540,105443,49033,24097,0
2398,25007,"Dukes County, MA",10914,7955,2789,11674,8400,2477,5166,5923,0
2399,25009,"Essex County, MA",363246,208723,149808,385370,222310,136316,58915,85994,0
2400,25011,"Franklin County, MA",37600,27024,9338,38821,24478,10364,17686,14114,0
2401,25013,"Hampden County, MA",197827,122571,72318,206101,112590,78685,50253,33905,0
2402,25015,"Hampshire County, MA",80406,56552,21366,84193,55367,21790,35186,33577,0
2403,25017,"Middlesex County, MA",746856,467173,266307,796735,520360,219793,200866,300567,0
2404,25019,"Nantucket County, MA",6097,3828,2185,6508,4146,1892,1643,2254,0
2405,25021,"Norfolk County, MA",350195,200891,144654,367695,221819,119723,56237,102096,0
2406,25023,"Plymouth County, MA",252396,129577,119833,271177,135513,115369,9744,20144,0
2407,25025,"Suffolk County, MA",282649,219208,58872,313283,245751,50421,160336,195330,0
2408,25027,"Worcester County, MA",364093,195667,162022,389951,198778,157682,33645,41096,0
2409,18001,"Adams County, IN",12998,3800,8936,13194,2805,9648,-5136,-6843,0
2410,18003,"Allen County, IN",146405,59834,84378,148632,55382,83930,-24544,-28548,0
2411,18005,"Bartholomew County, IN",29313,10622,18083,32717,9841,20640,-7461,-10799,0
2412,18007,"Benton County, IN",3577,1159,2329,3688,860,2579,-1170,-1719,0
2413,18009,"Blackford County, IN",4740,1927,2710,4839,1243,3350,-783,-2107,0
2414,18011,"Boone County, IN",27725,8326,18807,32537,10181,19654,-10481,-9473,0
2415,18013,"Brown County, IN",7590,3056,4330,7945,2518,5016,-1274,-2498,0
2416,18015,"Carroll County, IN",7793,2631,4993,8643,1892,6273,-2362,-4381,0
2417,18017,"Cass County, IN",14137,5365,8432,14209,3759,9701,-3067,-5942,0
2418,18019,"Clark County, IN",47062,20775,25422,51789,18808,30035,-4647,-11227,0
2419,18021,"Clay County, IN",10922,3630,7065,11335,2306,8531,-3435,-6225,0
2420,18023,"Clinton County, IN",9879,3307,6338,11936,2819,8531,-3031,-5712,0
2421,18025,"Crawford County, IN",4586,2040,2418,4593,1323,3015,-378,-1692,0
2422,18027,"Daviess County, IN",10246,2437,7638,10819,1800,8545,-5201,-6745,0
2423,18029,"Dearborn County, IN",22352,6527,15391,23987,4883,18113,-8864,-13230,0
2424,18031,"Decatur County, IN",10303,2941,7119,11178,2121,8490,-4178,-6369,0
2425,18033,"DeKalb County, IN",16314,5419,10586,16902,3942,12054,-5167,-8112,0
2426,18035,"Delaware County, IN",44924,22630,21231,45505,18153,24263,1399,-6110,1
2427,18037,"Dubois County, IN",18542,6522,11654,20095,5389,13365,-5132,-7976,0
2428,18039,"Elkhart County, IN",67768,24376,42348,66236,20740,41867,-17972,-21127,0
2429,18041,"Fayette County, IN",8816,3553,5044,9530,2252,6839,-1491,-4587,0
2430,18043,"Floyd County, IN",35283,14805,19868,37842,13945,21432,-5063,-7487,0
2431,18045,"Fountain County, IN",7103,2233,4660,7535,1476,5662,-2427,-4186,0
2432,18047,"Franklin County, IN",10549,2907,7421,11013,1969,8669,-4514,-6700,0
2433,18049,"Fulton County, IN",8120,2621,5315,8437,1960,6010,-2694,-4050,0
2434,18051,"Gibson County, IN",14718,4928,9487,15484,3721,11081,-4559,-7360,0
2435,18053,"Grant County, IN",25258,9589,15148,25572,7010,17008,-5559,-9998,0
2436,18055,"Greene County, IN",13101,4340,8457,13861,2929,10277,-4117,-7348,0
2437,18057,"Hamilton County, IN",136803,43794,90740,155958,57263,87404,-46946,-30141,0
2438,18059,"Hancock County, IN",32758,9303,22750,36496,8904,25074,-13447,-16170,0
2439,18061,"Harrison County, IN",17646,6600,10629,18558,4783,12943,-4029,-8160,0
2440,18063,"Hendricks County, IN",66590,21100,44308,76184,22600,48337,-23208,-25737,0
2441,18065,"Henry County, IN",18996,7613,10836,20155,5124,13895,-3223,-8771,0
2442,18067,"Howard County, IN",36194,15097,20284,37342,11215,23675,-5187,-12460,0
2443,18069,"Huntington County, IN",15753,4596,10862,16181,3506,11649,-6266,-8143,0
2444,18071,"Jackson County, IN",16704,5838,10419,17667,3843,12859,-4581,-9016,0
2445,18073,"Jasper County, IN",12891,4672,7955,13378,3329,9382,-3283,-6053,0
2446,18075,"Jay County, IN",7897,3063,4643,7986,1889,5697,-1580,-3808,0
2447,18077,"Jefferson County, IN",13120,5728,7096,13653,4326,8546,-1368,-4220,0
2448,18079,"Jennings County, IN",10237,3818,6112,11150,2364,8224,-2294,-5860,0
2449,18081,"Johnson County, IN",57362,17080,39136,67147,17318,45456,-22056,-28138,0
2450,18083,"Knox County, IN",15145,5228,9612,15516,3772,11077,-4384,-7305,0
2451,18085,"Kosciusko County, IN",30039,6862,22553,32441,6313,23935,-15691,-17622,0
2452,18087,"LaGrange County, IN",9311,2897,6227,9566,2080,7025,-3330,-4945,0
2453,18089,"Lake County, IN",201648,130824,68397,202801,116935,75625,62427,41310,0
2454,18091,"LaPorte County, IN",43657,24104,18609,45609,19798,22687,5495,-2889,1
2455,18093,"Lawrence County, IN",17822,5779,11622,19152,4210,14035,-5843,-9825,0
2456,18095,"Madison County, IN",52340,24404,26755,54377,18595,32376,-2351,-13781,0
2457,18097,"Marion County, IN",357745,215474,136131,366879,212899,130360,79343,82539,0
2458,18099,"Marshall County, IN",17751,6136,11260,18241,4798,12288,-5124,-7490,0
2459,18101,"Martin County, IN",4742,1351,3262,4809,881,3697,-1911,-2816,0
2460,18103,"Miami County, IN",12758,4220,8163,13482,2766,9975,-3943,-7209,0
2461,18105,"Monroe County, IN",40200,22885,16254,58454,34216,20592,6631,13624,0
2462,18107,"Montgomery County, IN",14349,4244,9768,15156,3362,11059,-5524,-7697,0
2463,18109,"Morgan County, IN",28251,7969,19591,31446,6040,23674,-11622,-17634,0
2464,18111,"Newton County, IN",5652,2212,3291,5795,1404,4077,-1079,-2673,0
2465,18113,"Noble County, IN",16244,5229,10680,17104,3904,12198,-5451,-8294,0
2466,18115,"Ohio County, IN",2812,992,1757,2921,686,2118,-765,-1432,0
2467,18117,"Orange County, IN",7753,2939,4615,8192,2048,5803,-1676,-3755,0
2468,18119,"Owen County, IN",8107,2823,5062,8557,1946,6153,-2239,-4207,0
2469,18121,"Parke County, IN",6504,2106,4228,6636,1441,4863,-2122,-3422,0
2470,18123,"Perry County, IN",7866,4314,3403,8055,3062,4556,911,-1494,1
2471,18125,"Pike County, IN",5924,2125,3627,5977,1297,4398,-1502,-3101,0
2472,18127,"Porter County, IN",72487,36950,34197,78253,33676,38832,2753,-5156,1
2473,18129,"Posey County, IN",12216,4531,7427,12467,3521,8404,-2896,-4883,0
2474,18131,"Pulaski County, IN",5399,1899,3366,5459,1327,3854,-1467,-2527,0
2475,18133,"Putnam County, IN",13813,4504,9004,14715,3356,10637,-4500,-7281,0
2476,18135,"Randolph County, IN",10188,3768,6218,10523,2446,7517,-2450,-5071,0
2477,18137,"Ripley County, IN",10982,3241,7484,12935,2471,9806,-4243,-7335,0
2478,18139,"Rush County, IN",7026,2221,4633,7214,1525,5292,-2412,-3767,0
2479,18143,"Scott County, IN",8716,3998,4539,9101,2642,6074,-541,-3432,0
2480,18145,"Shelby County, IN",16743,5357,10972,17994,4247,12718,-5615,-8471,0
2481,18147,"Spencer County, IN",9725,4026,5515,9979,2861,6572,-1489,-3711,0
2482,18141,"St. Joseph County, IN",110644,56458,52575,111842,52252,52021,3883,231,0
2483,18149,"Starke County, IN",8752,3809,4738,9316,2489,6367,-929,-3878,0
2484,18151,"Steuben County, IN",13677,4846,8542,14566,3744,10133,-3696,-6389,0
2485,18153,"Sullivan County, IN",8289,3191,4902,8559,2113,6138,-1711,-4025,0
2486,18155,"Switzerland County, IN",3397,1437,1872,3699,930,2558,-435,-1628,0
2487,18157,"Tippecanoe County, IN",56696,26642,28708,63339,27282,30768,-2066,-3486,0
2488,18159,"Tipton County, IN",7364,2432,4773,7510,1587,5589,-2341,-4002,0
2489,18161,"Union County, IN",3099,1018,2022,3291,715,2445,-1004,-1730,0
2490,18163,"Vanderburgh County, IN",72416,31659,39504,73369,28530,40496,-7845,-11966,0
2491,18165,"Vermillion County, IN",6578,2979,3426,6973,2081,4513,-447,-2432,0
2492,18167,"Vigo County, IN",39843,19707,19368,40127,15931,21937,339,-6006,1
2493,18169,"Wabash County, IN",12702,3929,8528,13552,3018,9821,-4599,-6803,0
2494,18171,"Warren County, IN",3798,1324,2377,3930,839,2898,-1053,-2059,0
2495,18173,"Warrick County, IN",24627,8791,15350,29939,9086,19113,-6559,-10027,0
2496,18175,"Washington County, IN",10725,3909,6532,11382,2636,8209,-2623,-5573,0
2497,18177,"Wayne County, IN",25458,10591,14321,25579,8322,16028,-3730,-7706,0
2498,18179,"Wells County, IN",12922,3434,9255,13286,2586,10005,-5821,-7419,0
2499,18181,"White County, IN",9901,3635,5970,10096,2590,6893,-2335,-4303,0
2500,18183,"Whitley County, IN",15005,4420,10257,15759,3379,11358,-5837,-7979,0
2501,17001,"Adams County, IL",30538,9627,20371,32310,7676,22790,-10744,-15114,0
2502,17003,"Alexander County, IL",3495,1961,1485,2820,1262,1496,476,-234,1
2503,17005,"Bond County, IL",7316,3016,4091,7570,2068,4888,-1075,-2820,0
2504,17007,"Boone County, IL",21333,9868,11084,23001,8986,12282,-1216,-3296,0
2505,17009,"Brown County, IL",2362,787,1511,2379,476,1796,-724,-1320,0
2506,17011,"Bureau County, IL",16599,8118,8151,16571,6029,9281,-33,-3252,0
2507,17013,"Calhoun County, IL",2574,1079,1439,2571,739,1721,-360,-982,0
2508,17015,"Carroll County, IL",7370,3658,3551,7445,2447,4434,107,-1987,1
2509,17017,"Cass County, IL",4858,2050,2707,5124,1621,3216,-657,-1595,0
2510,17019,"Champaign County, IL",77620,40378,35086,91628,50137,33368,5292,16769,0
2511,17021,"Christian County, IL",14682,5487,8873,15477,3992,10543,-3386,-6551,0
2512,17023,"Clark County, IL",7843,2587,5138,7928,1877,5622,-2551,-3745,0
2513,17025,"Clay County, IL",5899,1581,4184,6350,1020,5021,-2603,-4001,0
2514,17027,"Clinton County, IL",16394,5577,10493,17419,3945,12412,-4916,-8467,0
2515,17029,"Coles County, IL",21338,9252,11623,21918,7309,13003,-2371,-5694,0
2516,17031,"Cook County, IL",1944401,1439123,479204,2180344,1611946,453287,959919,1158659,0
2517,17033,"Crawford County, IL",8598,2855,5577,8739,1992,6277,-2722,-4285,0
2518,17035,"Cumberland County, IL",5290,1640,3506,5571,1031,4206,-1866,-3175,0
2519,17037,"DeKalb County, IL",41020,21171,18906,43600,20466,19091,2265,1375,0
2520,17039,"De Witt County, IL",7338,2598,4576,7556,1910,5077,-1978,-3167,0
2521,17041,"Douglas County, IL",7889,2426,5331,8195,1949,5698,-2905,-3749,0
2522,17043,"DuPage County, IL",397173,197411,193333,430674,228622,166415,4078,62207,0
2523,17045,"Edgar County, IL",7810,2563,5125,7899,1793,5645,-2562,-3852,0
2524,17047,"Edwards County, IL",3225,754,2402,3324,434,2778,-1648,-2344,0
2525,17049,"Effingham County, IL",16595,3855,12491,17514,3083,13635,-8636,-10552,0
2526,17051,"Fayette County, IL",8963,2848,5950,9591,1819,7372,-3102,-5553,0
2527,17053,"Ford County, IL",6000,1654,4225,6396,1414,4480,-2571,-3066,0
2528,17055,"Franklin County, IL",17891,7245,10253,18711,4727,13116,-3008,-8389,0
2529,17057,"Fulton County, IL",15337,8324,6622,15797,6133,8492,1702,-2359,1
2530,17059,"Gallatin County, IL",2569,1028,1492,2707,657,1942,-464,-1285,0
2531,17061,"Greene County, IL",5614,2023,3446,5585,1205,4145,-1423,-2940,0
2532,17063,"Grundy County, IL",20956,9319,11198,23237,8065,13454,-1879,-5389,0
2533,17065,"Hamilton County, IL",3935,1266,2566,4156,802,3206,-1300,-2404,0
2534,17067,"Hancock County, IL",8229,3246,4810,9121,2139,6430,-1564,-4291,0
2535,17069,"Hardin County, IL",2330,742,1535,2148,420,1653,-793,-1233,0
2536,17071,"Henderson County, IL",3563,1977,1538,3518,1155,2155,439,-1000,1
2537,17073,"Henry County, IL",24279,12316,11564,24365,8871,13985,752,-5114,1
2538,17075,"Iroquois County, IL",12770,3408,9115,13102,2504,9750,-5707,-7246,0
2539,17077,"Jackson County, IL",21190,11306,9130,24617,11634,10843,2176,791,0
2540,17079,"Jasper County, IL",5038,1434,3511,5112,924,3975,-2077,-3051,0
2541,17081,"Jefferson County, IL",16303,6080,9805,16999,4425,11695,-3725,-7270,0
2542,17083,"Jersey County, IL",9940,3656,6032,10991,2679,7748,-2376,-5069,0
2543,17085,"Jo Daviess County, IL",11411,5660,5529,11334,4462,6121,131,-1659,1
2544,17087,"Johnson County, IL",5666,1571,3959,6089,1142,4649,-2388,-3507,0
2545,17089,"Kane County, IL",183631,91120,89502,199314,103665,82734,1618,20931,0
2546,17091,"Kankakee County, IL",45452,21574,23115,47305,18971,25129,-1541,-6158,0
2547,17093,"Kendall County, IL",45042,21219,23076,54055,24884,24961,-1857,-77,0
2548,17095,"Knox County, IL",22517,12993,9133,22503,10083,10737,3860,-654,1
2549,17097,"Lake County, IL",284032,151552,128609,303520,171095,109767,22943,61328,0
2550,17099,"LaSalle County, IL",47146,23023,23207,49743,19543,26689,-184,-7146,0
2551,17101,"Lawrence County, IL",5984,2010,3853,6058,1290,4521,-1843,-3231,0
2552,17103,"Lee County, IL",15275,6932,8046,15489,5528,8612,-1114,-3084,0
2553,17105,"Livingston County, IL",15019,5014,9745,15342,4023,10208,-4731,-6185,0
2554,17107,"Logan County, IL",12037,3974,7835,12401,3313,8181,-3861,-4868,0
2555,17115,"Macon County, IL",48742,22688,25249,48060,18343,26866,-2561,-8523,0
2556,17117,"Macoupin County, IL",20947,9440,10909,22391,6689,14322,-1469,-7633,0
2557,17119,"Madison County, IL",122203,58813,60481,130179,50587,70490,-1668,-19903,0
2558,17121,"Marion County, IL",15728,6210,9229,17098,4369,11859,-3019,-7490,0
2559,17123,"Marshall County, IL",5842,2452,3287,5984,1789,3785,-835,-1996,0
2560,17125,"Mason County, IL",6272,2867,3265,6493,2014,4058,-398,-2044,0
2561,17127,"Massac County, IL",6492,2092,4278,6697,1558,4846,-2186,-3288,0
2562,17109,"McDonough County, IL",12439,5957,6142,13144,5288,6795,-185,-1507,0
2563,17111,"McHenry County, IL",133589,59691,71488,143930,60803,71612,-11797,-10809,0
2564,17113,"McLean County, IL",72756,31590,39638,81324,36196,37237,-8048,-1041,0
2565,17129,"Menard County, IL",6142,2095,3944,6515,1817,4231,-1849,-2414,0
2566,17131,"Mercer County, IL",8525,4503,3874,8525,3071,4807,629,-1736,1
2567,17133,"Monroe County, IL",17407,6205,10879,19354,5535,12629,-4674,-7094,0
2568,17135,"Montgomery County, IL",12120,5053,6771,12978,3504,8630,-1718,-5126,0
2569,17137,"Morgan County, IL",14071,5792,7962,14800,4696,9076,-2170,-4380,0
2570,17139,"Moultrie County, IL",6052,2142,3781,6283,1481,4455,-1639,-2974,0
2571,17141,"Ogle County, IL",23342,9504,13409,24193,8050,14352,-3905,-6302,0
2572,17143,"Peoria County, IL",78060,40050,36617,79102,38060,35633,3433,2427,0
2573,17145,"Perry County, IL",9533,3813,5497,9874,2462,6855,-1684,-4393,0
2574,17147,"Piatt County, IL",8697,3081,5412,9060,2645,5634,-2331,-2989,0
2575,17149,"Pike County, IL",7275,2276,4853,7530,1413,5754,-2577,-4341,0
2576,17151,"Pope County, IL",2219,649,1511,2136,375,1678,-862,-1303,0
2577,17153,"Pulaski County, IL",3001,1389,1562,2735,962,1675,-173,-713,0
2578,17155,"Putnam County, IL",3132,1558,1500,3112,1147,1767,58,-620,1
2579,17157,"Randolph County, IL",14380,5753,8284,14194,3439,10023,-2531,-6584,0
2580,17159,"Richland County, IL",7274,2360,4750,7649,1584,5739,-2390,-4155,0
2581,17161,"Rock Island County, IL",64880,39081,24888,63994,32298,26998,14193,5300,0
2582,17165,"Saline County, IL",10713,3697,6803,11384,2572,8276,-3106,-5704,0
2583,17167,"Sangamon County, IL",94032,41961,50131,98373,40907,49944,-8170,-9037,0
2584,17169,"Schuyler County, IL",3882,1726,2062,3834,1075,2524,-336,-1449,0
2585,17171,"Scott County, IL",2554,910,1586,2608,535,1966,-676,-1431,0
2586,17173,"Shelby County, IL",10383,3336,6837,11049,2288,8229,-3501,-5941,0
2587,17163,"St. Clair County, IL",118379,66749,49610,121436,60756,53857,17139,6899,0
2588,17175,"Stark County, IL",2661,1095,1527,2717,751,1778,-432,-1027,0
2589,17177,"Stephenson County, IL",17029,7954,8742,20343,7768,11083,-788,-3315,0
2590,17179,"Tazewell County, IL",60903,24385,35266,64751,20685,38707,-10881,-18022,0
2591,17181,"Union County, IL",8274,3135,4951,8616,2402,5790,-1816,-3388,0
2592,17183,"Vermilion County, IL",26153,10773,14888,30818,10039,19087,-4115,-9048,0
2593,17185,"Wabash County, IL",5127,1588,3473,5464,1151,4047,-1885,-2896,0
2594,17187,"Warren County, IL",7476,3893,3460,7807,2987,4275,433,-1288,1
2595,17189,"Washington County, IL",7398,2448,4787,7438,1448,5571,-2339,-4123,0
2596,17191,"Wayne County, IL",7676,1514,5984,8301,1048,6967,-4470,-5919,0
2597,17193,"White County, IL",7059,2187,4729,7335,1412,5640,-2542,-4228,0
2598,17195,"Whiteside County, IL",21492,12393,8676,25582,11035,12615,3717,-1580,1
2599,17197,"Will County, IL",249708,127522,118366,304226,151927,132720,9156,19207,0
2600,17199,"Williamson County, IL",29079,10622,17880,31852,8581,21570,-7258,-12989,0
2601,17201,"Winnebago County, IL",116101,60334,53722,120055,55713,55624,6612,89,0
2602,17203,"Woodford County, IL",18848,5564,12947,19864,5092,13207,-7383,-8115,0
2603,30001,"Beaverhead County, MT",4749,1347,3251,4849,1143,3353,-1904,-2210,0
2604,30003,"Big Horn County, MT",4561,2830,1655,4237,2094,1853,1175,241,0
2605,30005,"Blaine County, MT",2832,1598,1169,2684,1202,1268,429,-66,1
2606,30007,"Broadwater County, MT",3005,761,2150,3133,573,2348,-1389,-1775,0
2607,30009,"Carbon County, MT",5806,2126,3513,5991,1828,3748,-1387,-1920,0
2608,30011,"Carter County, MT",794,96,678,786,70,678,-582,-608,0
2609,30013,"Cascade County, MT",33952,14949,18039,34571,12175,19632,-3090,-7457,0
2610,30015,"Chouteau County, MT",2804,969,1751,2603,732,1679,-782,-947,0
2611,30017,"Custer County, MT",5336,1824,3353,5185,1176,3657,-1529,-2481,0
2612,30019,"Daniels County, MT",1001,236,735,962,168,730,-499,-562,0
2613,30021,"Dawson County, MT",4417,1219,3024,4409,787,3320,-1805,-2533,0
2614,30023,"Deer Lodge County, MT",4408,2829,1431,4206,2058,1763,1398,295,0
2615,30025,"Fallon County, MT",1399,236,1123,1484,154,1279,-887,-1125,0
2616,30027,"Fergus County, MT",6044,1628,4243,5840,1202,4269,-2615,-3067,0
2617,30029,"Flathead County, MT",42465,13534,27694,47496,13293,30240,-14160,-16947,0
2618,30031,"Gallatin County, MT",47113,21534,24051,53819,24246,23802,-2517,444,0
2619,30033,"Garfield County, MT",700,66,622,718,34,653,-556,-619,0
2620,30035,"Glacier County, MT",4287,2784,1391,5075,3121,1620,1393,1501,0
2621,30037,"Golden Valley County, MT",479,110,351,474,71,365,-241,-294,0
2622,30039,"Granite County, MT",1705,533,1107,1777,472,1192,-574,-720,0
2623,30041,"Hill County, MT",6757,3372,3133,6445,2371,3478,239,-1107,1
2624,30043,"Jefferson County, MT",6490,2256,4042,6714,1998,4177,-1786,-2179,0
2625,30045,"Judith Basin County, MT",1212,336,852,1208,235,872,-516,-637,0
2626,30047,"Lake County, MT",13156,5715,7084,13181,4776,7530,-1369,-2754,0
2627,30049,"Lewis and Clark County, MT",33032,15479,16673,35296,14478,16895,-1194,-2417,0
2628,30051,"Liberty County, MT",983,257,698,961,206,698,-441,-492,0
2629,30053,"Lincoln County, MT",8869,2544,6045,9330,2041,6729,-3501,-4688,0
2630,30057,"Madison County, MT",4511,1285,3115,4743,1180,3297,-1830,-2117,0
2631,30055,"McCone County, MT",988,221,742,1095,154,862,-521,-708,0
2632,30059,"Meagher County, MT",972,269,670,977,193,729,-401,-536,0
2633,30061,"Mineral County, MT",2009,698,1212,2012,519,1330,-514,-811,0
2634,30063,"Missoula County, MT",59374,34380,23285,60722,31543,22250,11095,9293,0
2635,30065,"Musselshell County, MT",2353,482,1792,2441,332,1967,-1310,-1635,0
2636,30067,"Park County, MT",8634,3728,4637,9359,3595,4980,-909,-1385,0
2637,30069,"Petroleum County, MT",298,49,240,322,30,278,-191,-248,0
2638,30071,"Phillips County, MT",2228,471,1688,2171,318,1723,-1217,-1405,0
2639,30073,"Pondera County, MT",2704,969,1666,2723,738,1799,-697,-1061,0
2640,30075,"Powder River County, MT",1019,170,833,1053,127,884,-663,-757,0
2641,30077,"Powell County, MT",2763,884,1798,2794,551,2029,-914,-1478,0
2642,30079,"Prairie County, MT",701,167,518,689,100,556,-351,-456,0
2643,30081,"Ravalli County, MT",19797,6466,12817,22556,6223,14810,-6351,-8587,0
2644,30083,"Richland County, MT",4602,992,3479,4871,671,3908,-2487,-3237,0
2645,30085,"Roosevelt County, MT",3618,2044,1503,3652,1560,1797,541,-237,1
2646,30087,"Rosebud County, MT",3610,1478,2035,3453,987,2253,-557,-1266,0
2647,30089,"Sanders County, MT",5888,1716,3971,5953,1218,4286,-2255,-3068,0
2648,30091,"Sheridan County, MT",1920,661,1203,1835,477,1241,-542,-764,0
2649,30093,"Silver Bow County, MT",16617,10782,5374,16452,8619,6376,5408,2243,0
2650,30095,"Stillwater County, MT",4560,1209,3237,4873,908,3661,-2028,-2753,0
2651,30097,"Sweet Grass County, MT",2105,473,1584,2107,402,1595,-1111,-1193,0
2652,30099,"Teton County, MT",3250,1073,2091,3188,808,2170,-1018,-1362,0
2653,30101,"Toole County, MT",2102,582,1440,2037,402,1497,-858,-1095,0
2654,30103,"Treasure County, MT",453,114,317,443,59,351,-203,-292,0
2655,30105,"Valley County, MT",3860,1386,2337,3894,886,2698,-951,-1812,0
2656,30107,"Wheatland County, MT",989,272,690,946,179,702,-418,-523,0
2657,30109,"Wibaux County, MT",544,25,421,541,55,463,-396,-408,0
2658,30111,"Yellowstone County, MT",68561,26275,40421,70486,22171,40920,-14146,-18749,0
2659,31001,"Adams County, NE",12451,3991,8235,13513,3302,9287,-4244,-5985,0
2660,31003,"Antelope County, NE",3209,571,2585,3281,383,2732,-2014,-2349,0
2661,31005,"Arthur County, NE",261,30,227,273,17,244,-197,-227,0
2662,31007,"Banner County, NE",402,55,339,402,19,357,-284,-338,0
2663,31009,"Blaine County, NE",301,29,268,317,30,276,-239,-246,0
2664,31011,"Boone County, NE",2799,615,2136,2905,414,2299,-1521,-1885,0
2665,31013,"Box Butte County, NE",4541,1634,2795,4924,965,3617,-1161,-2652,0
2666,31015,"Boyd County, NE",1047,186,852,1156,128,983,-666,-855,0
2667,31017,"Brown County, NE",1545,223,1298,1597,153,1385,-1075,-1232,0
2668,31019,"Buffalo County, NE",19057,5266,13378,21129,4763,14569,-8112,-9806,0
2669,31021,"Burt County, NE",3343,1280,2016,3558,930,2367,-736,-1437,0
2670,31023,"Butler County, NE",3818,1028,2729,3981,691,3079,-1701,-2388,0
2671,31025,"Cass County, NE",11952,4298,7453,12933,3484,8452,-3155,-4968,0
2672,31027,"Cedar County, NE",4260,952,3231,4420,571,3532,-2279,-2961,0
2673,31029,"Chase County, NE",1849,252,1573,1898,171,1648,-1321,-1477,0
2674,31031,"Cherry County, NE",3052,436,2557,3118,317,2623,-2121,-2306,0
2675,31033,"Cheyenne County, NE",4197,983,3134,4711,711,3665,-2151,-2954,0
2676,31035,"Clay County, NE",2916,662,2213,3065,477,2422,-1551,-1945,0
2677,31037,"Colfax County, NE",3047,959,2045,3214,859,2171,-1086,-1312,0
2678,31039,"Cuming County, NE",3928,1015,2858,4074,719,3122,-1843,-2403,0
2679,31041,"Custer County, NE",5414,1066,4251,5652,641,4695,-3185,-4054,0
2680,31043,"Dakota County, NE",5977,2831,3048,6279,2314,3616,-217,-1302,0
2681,31045,"Dawes County, NE",3634,1102,2435,3676,801,2632,-1333,-1831,0
2682,31047,"Dawson County, NE",7680,2157,5370,8635,2136,5984,-3213,-3848,0
2683,31049,"Deuel County, NE",1012,215,763,984,120,809,-548,-689,0
2684,31051,"Dixon County, NE",2666,870,1745,2782,556,2041,-875,-1485,0
2685,31053,"Dodge County, NE",14759,5588,8937,15529,4544,9933,-3349,-5389,0
2686,31055,"Douglas County, NE",210501,99261,108319,240433,113798,108077,-9058,5721,0
2687,31057,"Dundy County, NE",981,176,791,953,89,823,-615,-734,0
2688,31059,"Fillmore County, NE",2815,794,1972,2941,613,2130,-1178,-1517,0
2689,31061,"Franklin County, NE",1527,381,1110,1673,250,1347,-729,-1097,0
2690,31063,"Frontier County, NE",1422,381,1005,1328,161,1110,-624,-949,0
2691,31065,"Furnas County, NE",2215,422,1767,2340,304,1921,-1345,-1617,0
2692,31067,"Gage County, NE",9552,3870,5470,10048,2935,6380,-1600,-3445,0
2693,31069,"Garden County, NE",1088,242,829,1075,153,869,-587,-716,0
2694,31071,"Garfield County, NE",928,147,762,980,121,821,-615,-700,0
2695,31073,"Gosper County, NE",975,230,732,1010,166,794,-502,-628,0
2696,31075,"Grant County, NE",363,30,322,405,20,367,-292,-347,0
2697,31077,"Greeley County, NE",1181,340,820,1175,210,912,-480,-702,0
2698,31079,"Hall County, NE",19721,6971,12412,22060,6282,14408,-5441,-8126,0
2699,31081,"Hamilton County, NE",4824,1136,3582,5004,878,3783,-2446,-2905,0
2700,31083,"Harlan County, NE",1584,311,1248,1832,254,1496,-937,-1242,0
2701,31085,"Hayes County, NE",535,50,473,514,30,472,-423,-442,0
2702,31087,"Hitchcock County, NE",1739,310,1386,1468,161,1232,-1076,-1071,0
2703,31089,"Holt County, NE",4749,862,3789,5118,531,4354,-2927,-3823,0
2704,31091,"Hooker County, NE",394,59,330,417,40,355,-271,-315,0
2705,31093,"Howard County, NE",2856,914,1890,2994,544,2284,-976,-1740,0
2706,31095,"Jefferson County, NE",3416,1185,2156,3494,837,2399,-971,-1562,0
2707,31097,"Johnson County, NE",2057,790,1223,2089,563,1355,-433,-792,0
2708,31099,"Kearney County, NE",3156,761,2341,3296,550,2531,-1580,-1981,0
2709,31101,"Keith County, NE",4026,920,3036,4034,571,3235,-2116,-2664,0
2710,31103,"Keya Paha County, NE",481,80,392,519,40,460,-312,-420,0
2711,31105,"Kimball County, NE",1665,391,1222,1677,230,1330,-831,-1100,0
2712,31107,"Knox County, NE",4015,1055,2878,4115,720,3188,-1823,-2468,0
2713,31109,"Lancaster County, NE",123206,59970,61177,136223,61898,61588,-1207,310,0
2714,31111,"Lincoln County, NE",15266,4350,10545,16131,2913,12164,-6195,-9251,0
2715,31113,"Logan County, NE",431,68,356,453,32,400,-288,-368,0
2716,31115,"Loup County, NE",356,62,290,385,48,323,-228,-275,0
2717,31119,"Madison County, NE",13512,3368,9874,14343,2711,10628,-6506,-7917,0
2718,31117,"McPherson County, NE",290,41,237,287,14,257,-196,-243,0
2719,31121,"Merrick County, NE",3457,921,2477,3788,602,2926,-1556,-2324,0
2720,31123,"Morrill County, NE",2152,450,1658,2209,284,1802,-1208,-1518,0
2721,31125,"Nance County, NE",1604,477,1098,1621,281,1261,-621,-980,0
2722,31127,"Nemaha County, NE",3126,1089,1979,3161,785,2116,-890,-1331,0
2723,31129,"Nuckolls County, NE",2170,567,1563,2205,353,1726,-996,-1373,0
2724,31131,"Otoe County, NE",6905,2542,4226,7457,2025,4860,-1684,-2835,0
2725,31133,"Pawnee County, NE",1330,396,897,1327,279,974,-501,-695,0
2726,31135,"Perkins County, NE",1391,237,1133,1455,161,1217,-896,-1056,0
2727,31137,"Phelps County, NE",4336,875,3372,4695,572,3849,-2497,-3277,0
2728,31139,"Pierce County, NE",3414,637,2707,3630,382,3052,-2070,-2670,0
2729,31141,"Platte County, NE",13249,3095,9963,14433,2646,10965,-6868,-8319,0
2730,31143,"Polk County, NE",2446,527,1886,2582,413,2028,-1359,-1615,0
2731,31145,"Red Willow County, NE",4868,940,3855,5170,645,4258,-2915,-3613,0
2732,31147,"Richardson County, NE",3680,1180,2407,3805,818,2769,-1227,-1951,0
2733,31149,"Rock County, NE",784,103,669,798,70,687,-566,-617,0
2734,31151,"Saline County, NE",4832,2232,2518,5136,1733,3004,-286,-1271,0
2735,31153,"Sarpy County, NE",66166,24709,40318,80580,28033,45143,-15609,-17110,0
2736,31155,"Saunders County, NE",10203,3279,6725,10860,2523,7555,-3446,-5032,0
2737,31157,"Scotts Bluff County, NE",13867,4193,9427,14317,3207,10076,-5234,-6869,0
2738,31159,"Seward County, NE",7445,2362,4947,7922,1875,5454,-2585,-3579,0
2739,31161,"Sheridan County, NE",2450,389,2010,2608,287,2211,-1621,-1924,0
2740,31163,"Sherman County, NE",1508,549,919,1573,340,1150,-370,-810,0
2741,31165,"Sioux County, NE",735,101,623,736,81,616,-522,-535,0
2742,31167,"Stanton County, NE",2623,607,1945,2801,417,2187,-1338,-1770,0
2743,31169,"Thayer County, NE",2627,724,1853,2690,499,2051,-1129,-1552,0
2744,31171,"Thomas County, NE",408,42,360,393,30,344,-318,-314,0
2745,31173,"Thurston County, NE",1993,1153,823,2088,919,1043,330,-124,1
2746,31175,"Valley County, NE",2168,494,1643,2205,339,1780,-1149,-1441,0
2747,31177,"Washington County, NE",10121,3103,6857,10832,2623,7424,-3754,-4801,0
2748,31179,"Wayne County, NE",3659,1074,2493,3776,835,2693,-1419,-1858,0
2749,31181,"Webster County, NE",1730,440,1255,1708,306,1330,-815,-1024,0
2750,31183,"Wheeler County, NE",446,93,345,465,62,377,-252,-315,0
2751,31185,"York County, NE",6246,1352,4814,6381,1186,4700,-3462,-3514,0
2752,21001,"Adair County, KY",7600,1660,5841,8233,1323,6637,-4181,-5314,0
2753,21003,"Allen County, KY",7099,1808,5184,8096,1349,6466,-3376,-5117,0
2754,21005,"Anderson County, KY",10318,3315,6822,11422,2634,8242,-3507,-5608,0
2755,21007,"Ballard County, KY",3895,1189,2647,4101,816,3161,-1458,-2345,0
2756,21009,"Barren County, KY",16565,5400,10922,18488,4275,13483,-5522,-9208,0
2757,21011,"Bath County, KY",4122,1770,2275,4587,1361,3082,-505,-1721,0
2758,21013,"Bell County, KY",9482,2224,7127,9718,1720,7764,-4903,-6044,0
2759,21015,"Boone County, KY",52495,15628,35920,57618,15026,39082,-20292,-24056,0
2760,21017,"Bourbon County, KY",7909,3075,4692,8803,2791,5569,-1617,-2778,0
2761,21019,"Boyd County, KY",19040,7776,10883,20454,6021,13591,-3107,-7570,0
2762,21021,"Boyle County, KY",12368,4471,7703,12946,4281,8040,-3232,-3759,0
2763,21023,"Bracken County, KY",3230,1147,2029,3527,705,2711,-882,-2006,0
2764,21025,"Breathitt County, KY",5008,1562,3318,5738,1537,3991,-1756,-2454,0
2765,21027,"Breckinridge County, KY",7967,2825,5025,8774,1960,6484,-2200,-4524,0
2766,21029,"Bullitt County, KY",31775,9971,21306,36069,8255,26210,-11335,-17955,0
2767,21031,"Butler County, KY",5058,1293,3716,5576,947,4428,-2423,-3481,0
2768,21033,"Caldwell County, KY",5860,1852,3904,5975,1260,4507,-2052,-3247,0
2769,21035,"Calloway County, KY",15064,5314,9438,16049,4749,10367,-4124,-5618,0
2770,21037,"Campbell County, KY",40173,15080,24240,42510,14658,25050,-9160,-10392,0
2771,21039,"Carlisle County, KY",2619,750,1835,2601,432,2094,-1085,-1662,0
2772,21041,"Carroll County, KY",3680,1629,1999,3855,1106,2588,-370,-1482,0
2773,21043,"Carter County, KY",8906,3383,5279,10278,2276,7587,-1896,-5311,0
2774,21045,"Casey County, KY",6091,1086,4904,6439,767,5482,-3818,-4715,0
2775,21047,"Christian County, KY",21953,8252,13475,22083,7188,14108,-5223,-6920,0
2776,21049,"Clark County, KY",15410,5228,9931,16205,4706,10710,-4703,-6004,0
2777,21051,"Clay County, KY",7383,1111,6176,6767,752,5861,-5065,-5109,0
2778,21053,"Clinton County, KY",4393,752,3569,4462,547,3809,-2817,-3262,0
2779,21055,"Crittenden County, KY",3854,960,2839,4037,617,3290,-1879,-2673,0
2780,21057,"Cumberland County, KY",2853,599,2216,3066,459,2502,-1617,-2043,0
2781,21059,"Daviess County, KY",42079,16208,25092,45807,14163,28907,-8884,-14744,0
2782,21061,"Edmonson County, KY",4664,1374,3232,5244,979,4135,-1858,-3156,0
2783,21063,"Elliott County, KY",2399,1186,1126,2855,740,2000,60,-1260,1
2784,21065,"Estill County, KY",5184,1356,3749,5545,1108,4236,-2393,-3128,0
2785,21067,"Fayette County, KY",125821,62078,60793,136315,69778,56894,1285,12884,0
2786,21069,"Fleming County, KY",5782,1911,3780,6260,1348,4722,-1869,-3374,0
2787,21071,"Floyd County, KY",14890,4733,9784,16540,4015,11993,-5051,-7978,0
2788,21073,"Franklin County, KY",23337,11535,11345,23865,10717,11819,190,-1102,1
2789,21075,"Fulton County, KY",2481,1022,1425,2382,774,1549,-403,-775,0
2790,21077,"Gallatin County, KY",3060,1238,1758,3338,749,2443,-520,-1694,0
2791,21079,"Garrard County, KY",7077,1661,5310,7623,1453,5904,-3649,-4451,0
2792,21081,"Grant County, KY",8606,2810,5664,9559,1910,7268,-2854,-5358,0
2793,21083,"Graves County, KY",15493,4547,10699,16606,3308,12671,-6152,-9363,0
2794,21085,"Grayson County, KY",9269,2744,6404,10576,1959,8219,-3660,-6260,0
2795,21087,"Green County, KY",4856,1165,3634,5333,832,4372,-2469,-3540,0
2796,21089,"Greenup County, KY",15159,6027,8855,16277,4146,11546,-2828,-7400,0
2797,21091,"Hancock County, KY",4133,1833,2212,4295,1244,2788,-379,-1544,0
2798,21093,"Hardin County, KY",39212,15214,23357,43156,13944,26971,-8143,-13027,0
2799,21095,"Harlan County, KY",10658,1830,8653,10757,1372,9129,-6823,-7757,0
2800,21097,"Harrison County, KY",7163,2471,4556,7781,2031,5435,-2085,-3404,0
2801,21099,"Hart County, KY",6621,2283,4256,7264,1730,5320,-1973,-3590,0
2802,21101,"Henderson County, KY",18614,8091,10296,19710,6707,12159,-2205,-5452,0
2803,21103,"Henry County, KY",6584,2529,3940,7149,1828,4944,-1411,-3116,0
2804,21105,"Hickman County, KY",2139,686,1431,2157,449,1657,-745,-1208,0
2805,21107,"Hopkins County, KY",19765,5789,13681,20345,4310,15277,-7892,-10967,0
2806,21109,"Jackson County, KY",5061,612,4365,5501,482,4889,-3753,-4407,0
2807,21111,"Jefferson County, KY",339500,186164,148415,353099,190836,143768,37749,47068,0
2808,21113,"Jessamine County, KY",20620,6001,14232,23326,6144,15474,-8231,-9330,0
2809,21115,"Johnson County, KY",9035,1723,7095,9572,1250,8043,-5372,-6793,0
2810,21117,"Kenton County, KY",67679,24917,41387,71998,24214,42958,-16470,-18744,0
2811,21119,"Knott County, KY",5693,1420,4130,5763,1245,4357,-2710,-3112,0
2812,21121,"Knox County, KY",11100,2484,8467,12012,1761,9885,-5983,-8124,0
2813,21123,"Larue County, KY",5764,1733,3911,6367,1278,4799,-2178,-3521,0
2814,21125,"Laurel County, KY",22408,3905,18151,24833,3440,20592,-14246,-17152,0
2815,21127,"Lawrence County, KY",5592,1520,3995,6042,1045,4816,-2475,-3771,0
2816,21129,"Lee County, KY",2623,595,1977,2667,444,2151,-1382,-1707,0
2817,21131,"Leslie County, KY",4950,433,4439,4492,400,4015,-4006,-3615,0
2818,21133,"Letcher County, KY",8758,1702,6811,9134,1542,7293,-5109,-5751,0
2819,21135,"Lewis County, KY",4769,1342,3326,5298,785,4363,-1984,-3578,0
2820,21137,"Lincoln County, KY",9152,2582,6416,9561,1865,7338,-3834,-5473,0
2821,21139,"Livingston County, KY",4511,1346,3089,4645,887,3570,-1743,-2683,0
2822,21141,"Logan County, KY",10509,3469,6899,10899,2755,7778,-3430,-5023,0
2823,21143,"Lyon County, KY",3838,1373,2412,3962,1045,2789,-1039,-1744,0
2824,21151,"Madison County, KY",33317,11512,21128,37371,11793,23431,-9616,-11638,0
2825,21153,"Magoffin County, KY",4905,1433,3391,5116,1172,3824,-1958,-2652,0
2826,21155,"Marion County, KY",7316,3418,3800,8111,2679,5122,-382,-2443,0
2827,21157,"Marshall County, KY",15714,5022,10402,16698,3672,12322,-5380,-8650,0
2828,21159,"Martin County, KY",3824,574,3180,3953,363,3503,-2606,-3140,0
2829,21161,"Mason County, KY",6879,2592,4197,7219,1970,4944,-1605,-2974,0
2830,21145,"McCracken County, KY",30540,10062,19979,31307,9134,20774,-9917,-11640,0
2831,21147,"McCreary County, KY",5704,1069,4564,5776,664,5012,-3495,-4348,0
2832,21149,"McLean County, KY",4200,1432,2705,4566,988,3381,-1273,-2393,0
2833,21163,"Meade County, KY",10915,4122,6606,12231,3026,8660,-2484,-5634,0
2834,21165,"Menifee County, KY",2598,1048,1484,2779,700,2010,-436,-1310,0
2835,21167,"Mercer County, KY",9936,2966,6820,10585,2395,7740,-3854,-5345,0
2836,21169,"Metcalfe County, KY",4184,1425,2676,4620,976,3491,-1251,-2515,0
2837,21171,"Monroe County, KY",4746,936,3762,4991,601,4278,-2826,-3677,0
2838,21173,"Montgomery County, KY",10248,3701,6398,11452,3158,7856,-2697,-4698,0
2839,21175,"Morgan County, KY",4472,1369,3021,4775,1006,3628,-1652,-2622,0
2840,21177,"Muhlenberg County, KY",12737,4771,7762,13060,3272,9393,-2991,-6121,0
2841,21179,"Nelson County, KY",18532,7611,10673,20802,6434,13431,-3062,-6997,0
2842,21181,"Nicholas County, KY",2580,948,1583,2841,787,1957,-635,-1170,0
2843,21183,"Ohio County, KY",9646,2987,6470,10398,2080,7942,-3483,-5862,0
2844,21185,"Oldham County, KY",29873,9240,20179,32853,10268,20469,-10939,-10201,0
2845,21187,"Owen County, KY",4555,1501,2971,5001,1062,3745,-1470,-2683,0
2846,21189,"Owsley County, KY",1580,283,1279,1759,256,1474,-996,-1218,0
2847,21191,"Pendleton County, KY",5534,1859,3556,6007,1164,4604,-1697,-3440,0
2848,21193,"Perry County, KY",10240,2047,8040,10572,2136,8158,-5993,-6022,0
2849,21195,"Pike County, KY",23632,5645,17589,24665,4280,19747,-11944,-15467,0
2850,21197,"Powell County, KY",4441,1620,2726,4957,1272,3513,-1106,-2241,0
2851,21199,"Pulaski County, KY",26003,4976,20714,28041,4208,22902,-15738,-18694,0
2852,21201,"Robertson County, KY",935,340,579,1013,222,759,-239,-537,0
2853,21203,"Rockcastle County, KY",6216,1097,5028,6691,915,5609,-3931,-4694,0
2854,21205,"Rowan County, KY",7641,3438,4035,8848,3295,5174,-597,-1879,0
2855,21207,"Russell County, KY",7907,1445,6346,8174,1093,6863,-4901,-5770,0
2856,21209,"Scott County, KY",20565,7532,12679,24200,7715,15052,-5147,-7337,0
2857,21211,"Shelby County, KY",18659,6634,11790,20580,6276,13196,-5156,-6920,0
2858,21213,"Simpson County, KY",7089,2650,4355,7531,2144,5077,-1705,-2933,0
2859,21215,"Spencer County, KY",8431,2549,5726,9515,1921,7196,-3177,-5275,0
2860,21217,"Taylor County, KY",10946,3284,7551,11306,2553,8320,-4267,-5767,0
2861,21219,"Todd County, KY",4718,1403,3247,4779,1042,3612,-1844,-2570,0
2862,21221,"Trigg County, KY",6740,2115,4520,6751,1587,4931,-2405,-3344,0
2863,21223,"Trimble County, KY",3540,1355,2133,3798,879,2771,-778,-1892,0
2864,21225,"Union County, KY",5975,1941,3952,6211,1331,4701,-2011,-3370,0
2865,21227,"Warren County, KY",43889,16805,26384,48454,16966,28673,-9579,-11707,0
2866,21229,"Washington County, KY",5218,1669,3495,5636,1420,4013,-1826,-2593,0
2867,21231,"Wayne County, KY",7210,1855,5289,7992,1431,6371,-3434,-4940,0
2868,21233,"Webster County, KY",5470,1765,3607,5805,1240,4397,-1842,-3157,0
2869,21235,"Whitley County, KY",13068,2683,10232,13774,2067,11312,-7549,-9245,0
2870,21237,"Wolfe County, KY",2559,976,1542,2635,753,1804,-566,-1051,0
2871,21239,"Woodford County, KY",12331,4883,7218,13563,4958,7697,-2335,-2739,0
2872,19001,"Adair County, IA",3959,1788,2110,3811,1133,2461,-322,-1328,0
2873,19003,"Adams County, IA",2158,1018,1103,2106,565,1395,-85,-830,0
2874,19005,"Allamakee County, IA",6824,3511,3230,6923,2421,4093,281,-1672,1
2875,19007,"Appanoose County, IA",6176,2934,3153,6136,1814,4033,-219,-2219,0
2876,19009,"Audubon County, IA",3439,1608,1800,3412,1080,2136,-192,-1056,0
2877,19011,"Benton County, IA",13959,6850,6935,13844,4678,8232,-85,-3554,0
2878,19013,"Black Hawk County, IA",66205,39338,26078,64405,32233,27476,13260,4757,0
2879,19015,"Boone County, IA",14237,7457,6540,14196,5541,7484,917,-1943,1
2880,19017,"Bremer County, IA",13218,6710,6383,13538,5356,7208,327,-1852,1
2881,19019,"Buchanan County, IA",10478,5903,4443,10252,3970,5510,1460,-1540,1
2882,19021,"Buena Vista County, IA",8322,3683,4548,8278,2856,4903,-865,-2047,0
2883,19023,"Butler County, IA",7510,3321,4104,7513,2157,4921,-783,-2764,0
2884,19025,"Calhoun County, IA",5190,2232,2890,5159,1398,3468,-658,-2070,0
2885,19027,"Carroll County, IA",10581,4912,5577,10544,3309,6638,-665,-3329,0
2886,19029,"Cass County, IA",7167,2856,4212,7125,1951,4761,-1356,-2810,0
2887,19031,"Cedar County, IA",9548,4931,4510,9541,3599,5295,421,-1696,1
2888,19033,"Cerro Gordo County, IA",23548,13204,10084,22965,9862,11621,3120,-1759,1
2889,19035,"Cherokee County, IA",6367,2623,3656,6258,1679,4192,-1033,-2513,0
2890,19037,"Chickasaw County, IA",6462,3552,2836,6435,2266,3742,716,-1476,1
2891,19039,"Clarke County, IA",4398,2187,2124,4454,1465,2713,63,-1248,1
2892,19041,"Clay County, IA",8400,3363,4934,8617,2249,5877,-1571,-3628,0
2893,19043,"Clayton County, IA",9035,4768,4146,9129,3237,5317,622,-2080,1
2894,19045,"Clinton County, IA",24873,15123,9423,23067,10095,11276,5700,-1181,1
2895,19047,"Crawford County, IA",6686,3035,3584,6935,1991,4617,-549,-2626,0
2896,19049,"Dallas County, IA",37799,16466,20921,38252,15701,19339,-4455,-3638,0
2897,19051,"Davis County, IA",3738,1518,2133,3882,977,2723,-615,-1746,0
2898,19053,"Decatur County, IA",3812,1790,1945,3734,1201,2296,-155,-1095,0
2899,19055,"Delaware County, IA",9323,4605,4628,9241,2957,5694,-23,-2737,0
2900,19057,"Des Moines County, IA",20264,11873,8130,19103,8212,9529,3743,-1317,1
2901,19059,"Dickinson County, IA",10118,4088,5911,10354,3056,6753,-1823,-3697,0
2902,19061,"Dubuque County, IA",50516,28600,21265,49721,22850,23460,7335,-610,1
2903,19063,"Emmet County, IA",4646,2087,2499,4753,1357,3124,-412,-1767,0
2904,19065,"Fayette County, IA",10309,5709,4484,9975,3689,5620,1225,-1931,1
2905,19067,"Floyd County, IA",8228,4674,3466,8060,3179,4375,1208,-1196,1
2906,19069,"Franklin County, IA",5133,2256,2818,4968,1493,3163,-562,-1670,0
2907,19071,"Fremont County, IA",3655,1636,1971,3595,963,2407,-335,-1444,0
2908,19073,"Greene County, IA",4804,2369,2373,4821,1691,2820,-4,-1129,0
2909,19075,"Grundy County, IA",6890,2615,4205,6872,1856,4527,-1590,-2671,0
2910,19077,"Guthrie County, IA",5843,2565,3164,5750,1732,3628,-599,-1896,0
2911,19079,"Hamilton County, IA",7872,3776,3986,7694,2726,4463,-210,-1737,0
2912,19081,"Hancock County, IA",5881,2506,3306,5871,1587,3977,-800,-2390,0
2913,19083,"Hardin County, IA",8775,4021,4647,8533,2787,5254,-626,-2467,0
2914,19085,"Harrison County, IA",7282,3131,4059,7465,2131,4902,-928,-2771,0
2915,19087,"Henry County, IA",9613,4451,5025,9404,2904,5779,-574,-2875,0
2916,19089,"Howard County, IA",4625,2767,1793,4559,1677,2611,974,-934,1
2917,19091,"Humboldt County, IA",5124,1967,3099,5087,1252,3568,-1132,-2316,0
2918,19093,"Ida County, IA",3626,1317,2276,3612,792,2655,-959,-1863,0
2919,19095,"Iowa County, IA",8788,4118,4551,8904,3084,5205,-433,-2121,0
2920,19097,"Jackson County, IA",10166,5877,4171,10310,3837,5824,1706,-1987,1
2921,19099,"Jasper County, IA",19385,10240,8868,19034,7109,10560,1372,-3451,1
2922,19101,"Jefferson County, IA",8405,4772,3429,8156,3710,3748,1343,-38,1
2923,19103,"Johnson County, IA",74928,50090,23556,76940,50200,21044,26534,29156,0
2924,19105,"Jones County, IA",10371,5514,4712,10133,3787,5720,802,-1933,1
2925,19107,"Keokuk County, IA",5221,2298,2840,4985,1342,3390,-542,-2048,0
2926,19109,"Kossuth County, IA",8833,3824,4914,8607,2543,5653,-1090,-3110,0
2927,19111,"Lee County, IA",16488,9428,6787,16151,6215,8803,2641,-2588,1
2928,19113,"Linn County, IA",117122,68028,47427,117098,58935,48390,20601,10545,0
2929,19115,"Louisa County, IA",4921,2449,2416,5008,1648,3069,33,-1421,1
2930,19117,"Lucas County, IA",4273,1977,2248,4354,1239,2877,-271,-1638,0
2931,19119,"Lyon County, IA",6466,1416,4965,6377,920,5192,-3549,-4272,0
2932,19121,"Madison County, IA",8140,3508,4492,8636,2678,5360,-984,-2682,0
2933,19123,"Mahaska County, IA",10777,4207,6420,10632,2619,7432,-2213,-4813,0
2934,19125,"Marion County, IA",17536,7478,9810,17816,5482,10962,-2332,-5480,0
2935,19127,"Marshall County, IA",18727,10085,8411,17980,7652,9146,1674,-1494,1
2936,19129,"Mills County, IA",7169,2842,4211,7698,2090,5067,-1369,-2977,0
2937,19131,"Mitchell County, IA",5580,2831,2643,5417,1888,3190,188,-1302,1
2938,19133,"Monona County, IA",4707,2098,2555,4572,1247,3120,-457,-1873,0
2939,19135,"Monroe County, IA",3802,1729,2022,3865,1056,2638,-293,-1582,0
2940,19137,"Montgomery County, IA",5000,1919,2999,5044,1314,3436,-1080,-2122,0
2941,19139,"Muscatine County, IA",19726,11213,8152,19434,8368,9584,3061,-1216,1
2942,19141,"O'Brien County, IA",7295,1964,5259,7406,1315,5752,-3295,-4437,0
2943,19143,"Osceola County, IA",3179,909,2225,3213,552,2531,-1316,-1979,0
2944,19145,"Page County, IA",7014,2588,4338,7044,1807,4893,-1750,-3086,0
2945,19147,"Palo Alto County, IA",4857,2124,2649,4703,1398,3081,-525,-1683,0
2946,19149,"Plymouth County, IA",12909,4148,8577,13190,2885,9680,-4429,-6795,0
2947,19151,"Pocahontas County, IA",3992,1518,2388,3865,963,2702,-870,-1739,0
2948,19153,"Polk County, IA",227563,128264,96029,231555,119804,93492,32235,26312,0
2949,19155,"Pottawattamie County, IA",41679,19347,21751,42680,15355,24447,-2404,-9092,0
2950,19157,"Poweshiek County, IA",9858,5307,4409,9833,4304,4946,898,-642,1
2951,19159,"Ringgold County, IA",2578,1181,1366,2707,753,1824,-185,-1071,0
2952,19161,"Sac County, IA",5256,2117,3086,5212,1270,3703,-969,-2433,0
2953,19163,"Scott County, IA",89826,50581,38223,86220,40440,39149,12358,1291,0
2954,19165,"Shelby County, IA",6456,2468,3903,6370,1662,4362,-1435,-2700,0
2955,19167,"Sioux County, IA",17181,2683,14361,18194,2300,14785,-11678,-12485,0
2956,19169,"Story County, IA",46529,25940,19557,50667,25709,19458,6383,6251,0
2957,19171,"Tama County, IA",8930,4737,4076,8752,3196,4971,661,-1775,1
2958,19173,"Taylor County, IA",2978,1261,1680,3029,758,2111,-419,-1353,0
2959,19175,"Union County, IA",5899,3029,2800,5832,1922,3525,229,-1603,1
2960,19177,"Van Buren County, IA",3540,1398,2058,3561,845,2527,-660,-1682,0
2961,19179,"Wapello County, IA",15630,8616,6777,15149,5594,8715,1839,-3121,1
2962,19181,"Warren County, IA",25875,12521,13031,27300,10411,14814,-510,-4403,0
2963,19183,"Washington County, IA",10880,5081,5540,10929,3943,6173,-459,-2230,0
2964,19185,"Wayne County, IA",2886,1251,1583,2940,719,2069,-332,-1350,0
2965,19187,"Webster County, IA",18118,9458,8453,17430,6305,10056,1005,-3751,1
2966,19189,"Winnebago County, IA",5878,2895,2897,5787,1931,3447,-2,-1516,0
2967,19191,"Winneshiek County, IA",11016,6245,4618,11362,5254,5344,1627,-90,1
2968,19193,"Woodbury County, IA",44702,22026,22136,43718,16210,24727,-110,-8517,0
2969,19195,"Worth County, IA",4143,2343,1743,4257,1530,2453,600,-923,1
2970,19197,"Wright County, IA",6174,2794,3309,6026,1896,3800,-515,-1904,0
2971,56001,"Albany County, WY",16052,7445,7851,17060,6890,7602,-406,-712,0
2972,56003,"Big Horn County, WY",5262,868,4269,5317,604,4067,-3401,-3463,0
2973,56005,"Campbell County, WY",17477,2163,14952,18199,1324,15778,-12789,-14454,0
2974,56007,"Carbon County, WY",6461,2109,4152,6374,1279,4409,-2043,-3130,0
2975,56009,"Converse County, WY",6287,1089,5043,6654,668,5520,-3954,-4852,0
2976,56011,"Crook County, WY",3657,426,3109,3826,273,3348,-2683,-3075,0
2977,56013,"Fremont County, WY",16817,5333,11072,17023,4200,11167,-5739,-6967,0
2978,56015,"Goshen County, WY",5758,1458,4178,5796,924,4418,-2720,-3494,0
2979,56017,"Hot Springs County, WY",2495,523,1894,2586,400,1939,-1371,-1539,0
2980,56019,"Johnson County, WY",4217,749,3362,4417,638,3477,-2613,-2839,0
2981,56021,"Laramie County, WY",38057,13807,23247,40969,11573,24847,-9440,-13274,0
2982,56023,"Lincoln County, WY",8573,1287,7144,8875,1105,6779,-5857,-5674,0
2983,56025,"Natrona County, WY",32057,8960,22129,33348,6577,23552,-13169,-16975,0
2984,56027,"Niobrara County, WY",1268,200,1022,1314,115,1116,-822,-1001,0
2985,56029,"Park County, WY",14492,2927,11234,15095,2535,11115,-8307,-8580,0
2986,56031,"Platte County, WY",4500,1223,3136,4529,719,3437,-1913,-2718,0
2987,56033,"Sheridan County, WY",14225,3618,10267,14510,2927,10266,-6649,-7339,0
2988,56035,"Sublette County, WY",4337,767,3472,4390,644,3409,-2705,-2765,0
2989,56037,"Sweetwater County, WY",16750,4773,11427,17130,3231,12154,-6654,-8923,0
2990,56039,"Teton County, WY",11356,6211,4858,12627,7314,3921,1353,3393,0
2991,56041,"Uinta County, WY",8453,1628,6613,8470,1202,6154,-4985,-4952,0
2992,56043,"Washakie County, WY",3911,794,3013,3814,532,2911,-2219,-2379,0
2993,56045,"Weston County, WY",3323,422,2821,3526,299,3033,-2399,-2734,0
2994,22001,"Acadia Parish, LA",26834,6559,19931,27389,5638,21162,-13372,-15524,0
2995,22003,"Allen Parish, LA",9306,2616,6495,9245,2106,6867,-3879,-4761,0
2996,22005,"Ascension Parish, LA",51056,16343,33846,54678,16476,36143,-17503,-19667,0
2997,22007,"Assumption Parish, LA",10991,4754,6082,10904,3931,6714,-1328,-2783,0
2998,22009,"Avoyelles Parish, LA",17027,6075,10667,16586,5035,11165,-4592,-6130,0
2999,22011,"Beauregard Parish, LA",14223,2827,11111,15078,2393,12238,-8284,-9845,0
3000,22013,"Bienville Parish, LA",7203,3490,3641,7005,3129,3756,-151,-627,0
3001,22015,"Bossier Parish, LA",48559,12955,34986,49848,12641,35474,-22031,-22833,0
3002,22017,"Caddo Parish, LA",111516,57879,52378,105804,53483,49006,5501,4477,0
3003,22019,"Calcasieu Parish, LA",81718,28357,51844,83785,26296,54191,-23487,-27895,0
3004,22021,"Caldwell Parish, LA",4716,1016,3640,4692,788,3822,-2624,-3034,0
3005,22023,"Cameron Parish, LA",3744,408,3260,3692,323,3256,-2852,-2933,0
3006,22025,"Catahoula Parish, LA",4193,1408,2744,4856,1322,3479,-1336,-2157,0
3007,22027,"Claiborne Parish, LA",6732,3014,3649,6421,2717,3585,-635,-868,0
3008,22029,"Concordia Parish, LA",9380,3833,5450,8872,3272,5477,-1617,-2205,0
3009,22031,"De Soto Parish, LA",13050,5552,7353,13500,5165,8068,-1801,-2903,0
3010,22033,"East Baton Rouge Parish, LA",197912,102460,92235,196491,102828,84660,10225,18168,0
3011,22035,"East Carroll Parish, LA",3384,2244,1122,2939,1838,1059,1122,779,0
3012,22037,"East Feliciana Parish, LA",10209,4648,5397,10042,4235,5569,-749,-1334,0
3013,22039,"Evangeline Parish, LA",15765,5330,10176,14882,4208,10360,-4846,-6152,0
3014,22041,"Franklin Parish, LA",9336,2921,6294,9162,2506,6514,-3373,-4008,0
3015,22043,"Grant Parish, LA",8666,1421,7082,8821,1181,7408,-5661,-6227,0
3016,22045,"Iberia Parish, LA",33392,12129,20890,32454,10698,20903,-8761,-10205,0
3017,22047,"Iberville Parish, LA",17014,9548,7271,16043,8324,7320,2277,1004,0
3018,22049,"Jackson Parish, LA",7529,2305,5132,7464,2139,5169,-2827,-3030,0
3019,22053,"Jefferson Davis Parish, LA",13733,3483,10014,14277,3080,10775,-6531,-7695,0
3020,22051,"Jefferson Parish, LA",175733,70000,102325,181639,73670,100398,-32325,-26728,0
3021,22055,"Lafayette Parish, LA",98637,31766,64989,105603,32726,68195,-33223,-35469,0
3022,22057,"Lafourche Parish, LA",38725,9543,28332,41645,8423,31959,-18789,-23536,0
3023,22059,"La Salle Parish, LA",6572,764,5726,6569,605,5836,-4962,-5231,0
3024,22061,"Lincoln Parish, LA",18974,7947,10731,18669,7107,10761,-2784,-3654,0
3025,22063,"Livingston Parish, LA",54033,7448,45488,57730,6950,48824,-38040,-41874,0
3026,22065,"Madison Parish, LA",5187,3154,2000,4732,2744,1927,1154,817,0
3027,22067,"Morehouse Parish, LA",12613,5887,6591,11852,5155,6502,-704,-1347,0
3028,22069,"Natchitoches Parish, LA",17257,7941,9077,16621,7144,8968,-1136,-1824,0
3029,22071,"Orleans Parish, LA",157233,126199,27967,165812,133996,24292,98232,109704,0
3030,22073,"Ouachita Parish, LA",68437,26629,40927,68017,24428,41734,-14298,-17306,0
3031,22075,"Plaquemines Parish, LA",10235,3597,6469,10573,3347,6900,-2872,-3553,0
3032,22077,"Pointe Coupee Parish, LA",12147,5436,6548,11761,4764,6789,-1112,-2025,0
3033,22079,"Rapides Parish, LA",58008,20040,37187,56844,18322,36816,-17147,-18494,0
3034,22081,"Red River Parish, LA",4807,2253,2483,4422,1938,2391,-230,-453,0
3035,22083,"Richland Parish, LA",11507,4074,7316,9597,3157,6287,-3242,-3130,0
3036,22085,"Sabine Parish, LA",10050,2194,7735,9787,1703,7879,-5541,-6176,0
3037,22087,"St. Bernard Parish, LA",13944,5052,8497,15815,4960,10237,-3445,-5277,0
3038,22089,"St. Charles Parish, LA",25330,8894,15936,26192,8559,16621,-7042,-8062,0
3039,22091,"St. Helena Parish, LA",7093,4233,2756,5964,3353,2497,1477,856,0
3040,22093,"St. James Parish, LA",12391,7055,5209,12085,6418,5456,1846,962,0
3041,22095,"St. John the Baptist Parish, LA",21122,13178,7620,20743,12661,7569,5558,5092,0
3042,22097,"St. Landry Parish, LA",41647,19668,21475,39977,17209,21971,-1807,-4762,0
3043,22099,"St. Martin Parish, LA",25430,9419,15653,25750,8266,16873,-6234,-8607,0
3044,22101,"St. Mary Parish, LA",23636,9448,13883,22877,8050,14359,-4435,-6309,0
3045,22103,"St. Tammany Parish, LA",112884,25723,84710,124392,27717,90915,-58987,-63198,0
3046,22105,"Tangipahoa Parish, LA",50090,17720,31583,52416,16878,33959,-13863,-17081,0
3047,22107,"Tensas Parish, LA",2812,1564,1230,2548,1332,1182,334,150,0
3048,22109,"Terrebonne Parish, LA",42335,12071,29500,43896,10665,31902,-17429,-21237,0
3049,22111,"Union Parish, LA",10766,3075,7561,10894,2691,7972,-4486,-5281,0
3050,22113,"Vermilion Parish, LA",24984,5718,18909,25632,4857,20063,-13191,-15206,0
3051,22115,"Vernon Parish, LA",15606,3173,12146,16633,2665,13471,-8973,-10806,0
3052,22117,"Washington Parish, LA",18100,6351,11470,18628,5692,12556,-5119,-6864,0
3053,22119,"Webster Parish, LA",18413,6802,11397,18145,6260,11542,-4595,-5282,0
3054,22121,"West Baton Rouge Parish, LA",12772,5692,6920,12712,5383,6927,-1228,-1544,0
3055,22123,"West Carroll Parish, LA",4548,853,3628,4759,715,3970,-2775,-3255,0
3056,22125,"West Feliciana Parish, LA",5777,2441,3257,5799,2248,3390,-816,-1142,0
3057,22127,"Winn Parish, LA",6532,1919,4539,6372,1644,4608,-2620,-2964,0
3058,16001,"Ada County, ID",180361,77043,97471,195669,75677,93752,-20428,-18075,0
3059,16003,"Adams County, ID",2060,577,1413,2183,415,1556,-836,-1141,0
3060,16005,"Bannock County, ID",35260,13214,21010,33416,10342,17180,-7796,-6838,0
3061,16007,"Bear Lake County, ID",2822,302,2489,2928,255,2203,-2187,-1948,0
3062,16009,"Benewah County, ID",3884,1164,2596,4185,770,3103,-1432,-2333,0
3063,16011,"Bingham County, ID",17603,3822,13440,16625,2924,10907,-9618,-7983,0
3064,16013,"Blaine County, ID",10194,5992,3939,10724,6416,3340,2053,3076,0
3065,16015,"Boise County, ID",3345,953,2284,3814,777,2673,-1331,-1896,0
3066,16017,"Bonner County, ID",18536,6500,11367,20943,5819,13343,-4867,-7524,0
3067,16019,"Bonneville County, ID",43302,9929,32336,44221,8930,26699,-22407,-17769,0
3068,16021,"Boundary County, ID",4544,1225,3138,5163,933,3789,-1913,-2856,0
3069,16023,"Butte County, ID",1286,258,1001,1230,160,914,-743,-754,0
3070,16025,"Camas County, ID",578,159,402,590,110,410,-243,-300,0
3071,16027,"Canyon County, ID",66090,19866,44369,72785,16883,47222,-24503,-30339,0
3072,16029,"Caribou County, ID",3050,385,2608,3035,271,2275,-2223,-2004,0
3073,16031,"Cassia County, ID",8387,1093,7150,8178,1036,5949,-6057,-4913,0
3074,16033,"Clark County, ID",328,66,235,283,44,203,-169,-159,0
3075,16035,"Clearwater County, ID",3696,1032,2541,3801,704,2852,-1509,-2148,0
3076,16037,"Custer County, ID",2352,530,1744,2414,427,1777,-1214,-1350,0
3077,16039,"Elmore County, ID",8001,2513,5227,8522,1814,5816,-2714,-4002,0
3078,16041,"Franklin County, ID",5600,325,5195,5499,385,3901,-4870,-3516,0
3079,16043,"Fremont County, ID",5802,810,4907,5715,651,4090,-4097,-3439,0
3080,16045,"Gem County, ID",7490,1957,5311,7954,1229,5980,-3354,-4751,0
3081,16047,"Gooding County, ID",5118,1287,3696,5191,930,3743,-2409,-2813,0
3082,16049,"Idaho County, ID",7749,1722,5821,8233,1196,6441,-4099,-5245,0
3083,16051,"Jefferson County, ID",11381,1303,9895,11475,976,8436,-8592,-7460,0
3084,16053,"Jerome County, ID",6681,1699,4804,6751,1329,4644,-3105,-3315,0
3085,16055,"Kootenai County, ID",59764,18824,39347,66310,16264,44449,-20523,-28185,0
3086,16057,"Latah County, ID",16759,8306,7589,18173,8093,7265,717,828,0
3087,16059,"Lemhi County, ID",4109,960,3029,4096,733,3011,-2069,-2278,0
3088,16061,"Lewis County, ID",1612,396,1173,1590,270,1202,-777,-932,0
3089,16063,"Lincoln County, ID",1622,429,1141,1748,360,1184,-712,-824,0
3090,16065,"Madison County, ID",14412,832,13445,15688,1201,8941,-12613,-7740,0
3091,16067,"Minidoka County, ID",6973,1390,5442,6871,1167,4887,-4052,-3720,0
3092,16069,"Nez Perce County, ID",16848,6451,9967,17201,4828,10699,-3516,-5871,0
3093,16071,"Oneida County, ID",2089,217,1838,2068,184,1531,-1621,-1347,0
3094,16073,"Owyhee County, ID",3723,833,2794,3925,591,3052,-1961,-2461,0
3095,16075,"Payette County, ID",8495,2271,6004,8704,1507,6489,-3733,-4982,0
3096,16077,"Power County, ID",2903,982,1870,2758,699,1666,-888,-967,0
3097,16079,"Shoshone County, ID",5148,2277,2699,5120,1384,3297,-422,-1913,0
3098,16081,"Teton County, ID",4523,1926,2458,4976,2159,2167,-532,-8,0
3099,16083,"Twin Falls County, ID",28142,7541,19773,29874,6233,19828,-12232,-13595,0
3100,16085,"Valley County, ID",4919,2095,2664,5349,1913,2906,-569,-993,0
3101,16087,"Washington County, ID",4330,1104,3128,4455,776,3283,-2024,-2507,0
3102,33001,"Belknap County, NH",33771,15884,17568,35045,13517,19315,-1684,-5798,0
3103,33003,"Carroll County, NH",28464,13977,14207,29616,12987,14635,-230,-1648,0
3104,33005,"Cheshire County, NH",41071,25329,15135,41895,22064,16876,10194,5188,0
3105,33007,"Coos County, NH",15614,9091,6342,15627,6563,7952,2749,-1389,1
3106,33009,"Grafton County, NH",48765,29826,18207,51191,28510,19010,11619,9500,0
3107,33011,"Hillsborough County, NH",202765,101499,98103,214157,99589,100013,3396,-424,1
3108,33013,"Merrimack County, NH",80054,44635,34451,83648,40198,37674,10184,2524,0
3109,33015,"Rockingham County, NH",169794,80096,87809,181434,79994,90447,-7713,-10453,0
3110,33017,"Strafford County, NH",63762,36026,26779,69000,34894,29072,9247,5822,0
3111,33019,"Sullivan County, NH",21814,12166,9269,22683,10210,10796,2897,-586,1
